name,team_name,high_5s,player_team,super_10s,super_raids,super_tackles,total_defending_points,total_raid_points,red_cards,raid_bonus_points,success_tackles,defence_touch_points,defending_bonus_points,raid_touch_points,unsuccesful_tackles,success_raid_percent,empty_raid,tackle_success_rate,raids,match_player,tackles,points,raid_points_per_match,not_out_percentage,success_tackles_per_match,career_best_points,raid_map_locations,location,tackle_bonus_points,role,unsuccess_raids,success_raids,total_tackle_points,yellow_cards,green_cards,points_per_match_raid_tackle,points_defence_offence
Takamitsu Kono,Dabang Delhi K.C.,0,0,0,0,0,1,1,0,0,1,1,0,1,0,100,0,100.0,1,1,1,2,1.0,100.0,1.0,0,,,0,,0,1,1,0,0,2.0,2
Simon Kibura,Puneri Paltan,0,0,0,0,0,2,9,0,0,2,2,0,9,5,40,6,28.999999999999996,20,9,7,11,1.0,70.0,0.22,0,,,0,,6,8,2,0,0,1.22,11
Jang Lee,Patna Pirates,0,0,9,14,4,25,471,0,122,21,21,0,349,81,36,443,21.0,1048,106,102,496,4.44,78.15,0.24,0,,,0,,229,376,25,0,2,4.68,496
Taedeok Eom,Patna Pirates,0,0,0,0,1,8,14,0,3,7,7,0,11,36,29,13,16.0,35,35,43,22,0.4,65.71,0.23,0,,,0,,12,10,8,0,0,0.63,22
Sanjay Shrestha,Puneri Paltan,0,0,0,0,0,0,0,0,0,0,0,0,0,0,0,0,0.0,0,2,0,0,0.0,0.0,0.0,0,,,0,,0,0,0,0,0,0.0,0
Waleed Hasani,Puneri Paltan,0,0,0,1,0,0,14,0,2,0,0,0,12,1,45,0,0.0,22,6,1,14,2.33,45.45,0.0,0,,,0,,12,10,0,0,0,2.33,14
Sinotharan Kanesharajah,Bengaluru Bulls,0,0,0,1,0,1,5,0,1,1,1,0,4,1,25,5,50.0,8,3,2,6,1.67,87.5,0.33,0,,,0,,1,2,1,0,0,2.0,6
Wei Yang,Jaipur Pink Panthers,0,0,0,0,0,0,0,0,0,0,0,0,0,0,0,1,0.0,3,5,0,0,0.0,33.33,0.0,0,,,0,,2,0,0,0,0,0.0,0
Ajay Thakur,Tamil Thalaivas,0,0,29,23,0,22,794,0,126,22,22,0,668,64,38,672,26.0,1700,120,86,816,6.62,77.41,0.18,0,,,0,,384,643,22,0,19,6.8,816
Amit Chillar,Telugu Titans,2,0,0,0,4,59,1,0,0,55,55,0,1,99,17,4,36.0,6,35,154,60,0.03,83.33,1.69,0,,,0,,1,1,59,0,2,1.71,60
Anup Kumar,U Mumba,0,0,13,17,8,69,527,0,133,61,61,0,394,112,31,725,35.0,1346,91,173,596,5.79,85.14,0.76,0,,,0,,200,421,69,0,22,6.55,596
Bhupender Singh,U Mumba,1,0,0,4,1,12,71,0,22,11,11,0,49,33,23,113,25.0,212,47,44,83,1.51,75.94,0.26,0,,,0,,51,48,12,0,2,1.77,83
Chandran Ranjit,Gujarat Giants,0,0,9,15,3,27,503,0,164,24,24,0,339,53,37,406,31.0,1074,100,77,530,5.03,74.77,0.27,0,,,0,,271,397,27,0,0,5.3,530
Dadaso Awad,Dabang Delhi K.C.,0,0,0,0,3,17,5,0,0,14,14,0,5,30,14,18,32.0,28,12,44,22,0.42,78.57,1.42,0,,,0,,6,4,17,0,0,1.83,22
Deepak Hooda,Telugu Titans,4,0,35,23,8,99,1020,0,174,91,91,0,846,174,38,918,34.0,2171,157,265,1119,6.5,80.75,0.63,0,,,0,,418,835,99,0,5,7.13,1119
Dharmaraj Cheralathan,Haryana Steelers,12,0,0,0,25,261,43,0,15,236,236,0,28,261,16,136,47.0,176,123,497,304,0.35,93.75,2.12,0,,,0,,11,29,261,0,2,2.47,304
Dharmendra Singh,Bengal Warriors,0,0,0,0,0,0,0,0,0,0,0,0,0,0,0,0,0.0,0,0,0,0,,0.0,,0,,,0,,0,0,0,0,0,,0
Gangadhari Mallesh,Jaipur Pink Panthers,0,0,0,0,4,22,19,0,2,18,18,0,17,36,22,37,33.0,65,36,54,41,0.53,78.46,0.61,0,,,0,,14,14,22,0,0,1.14,41
Gurpreet Singh,Bengaluru Bulls,1,0,0,0,1,26,2,0,1,25,25,0,1,43,33,1,37.0,3,18,68,28,0.11,66.67,1.44,0,,,0,,1,1,26,0,1,1.56,28
GURVINDER SINGH,Gujarat Giants,0,0,1,2,1,18,82,0,25,17,17,0,57,48,26,109,26.0,225,45,65,100,1.82,74.67,0.4,0,,,0,,57,59,18,0,0,2.22,100
Jasmer Gulia,Telugu Titans,5,0,0,0,7,109,7,0,5,102,102,0,2,138,24,16,42.0,29,52,240,116,0.13,79.31,2.1,0,,,0,,6,7,109,0,3,2.23,116
Jasvir Singh,Tamil Thalaivas,0,0,7,7,7,32,380,0,57,25,25,0,323,62,29,511,28.999999999999996,1022,77,87,412,4.94,78.86,0.42,0,,,0,,216,295,32,0,17,5.35,412
Jeeva Gopal,Haryana Steelers,0,0,0,0,2,12,0,0,0,10,10,0,0,48,0,0,17.0,2,24,58,12,0.0,0.0,0.5,0,,,0,,2,0,12,0,0,0.5,12
Jeeva Kumar,U.P. Yoddha,5,0,0,0,23,257,1,0,0,234,234,0,1,353,25,3,40.0,4,136,587,258,0.01,100.0,1.89,0,,,0,,0,1,257,0,2,1.9,258
Jitesh Joshi,Puneri Paltan,2,0,0,0,2,16,53,0,10,14,14,0,43,43,34,55,25.0,125,19,57,69,2.79,78.4,0.84,0,,,0,,27,43,16,0,1,3.63,69
Kalimuthu Balamahendran,Telugu Titans,0,0,0,2,6,25,18,0,3,19,19,0,15,61,19,32,24.0,54,23,80,43,0.78,77.78,1.09,0,,,0,,12,10,25,0,1,1.87,43
Kashiling Adake,U Mumba,0,0,15,23,7,51,561,0,148,44,44,0,413,86,36,502,34.0,1190,92,130,612,6.1,77.82,0.55,0,,,0,,264,424,51,0,7,6.65,612
Kuldeep Singh,Patna Pirates,3,0,0,0,4,41,0,0,0,37,37,0,0,49,0,0,43.0,0,20,86,41,0.0,0.0,2.05,0,,,0,,0,0,41,0,0,2.05,41
Mahesh Goud,U.P. Yoddha,0,0,0,4,3,24,165,0,32,21,21,0,133,55,29,206,28.000000000000004,454,65,76,189,2.54,74.67,0.37,0,,,0,,115,133,24,0,2,2.91,189
Mahipal Narwal,Gujarat Giants,0,0,1,3,2,30,57,0,9,28,28,0,48,36,24,82,44.0,168,34,64,87,1.68,72.62,0.88,0,,,0,,46,40,30,0,0,2.56,87
Manjeet Chhillar,Tamil Thalaivas,25,0,2,5,17,391,225,0,36,374,374,0,189,377,25,408,50.0,724,132,751,616,1.7,81.22,2.96,0,,,0,,136,180,391,3,39,4.67,616
Manoj Kumar,Gujarat Giants,2,0,0,2,11,59,25,0,6,48,48,0,19,139,22,43,26.0,73,52,187,84,0.48,80.82,1.13,0,,,0,,14,16,59,0,3,1.62,84
Mohit Chhillar,Tamil Thalaivas,18,0,0,0,23,277,7,0,3,254,254,0,4,301,9,26,46.0,32,109,555,284,0.06,90.62,2.54,0,,,0,,3,3,277,0,11,2.61,284
Navneet Gautam,Jaipur Pink Panthers,1,0,0,0,1,21,1,0,1,20,20,0,0,63,0,5,24.0,6,31,83,22,0.03,83.33,0.68,0,,,0,,1,0,21,0,3,0.71,22
Nilesh Shinde,Bengal Warriors,7,0,0,0,14,135,18,0,12,121,121,0,6,166,15,51,42.0,75,69,287,153,0.26,82.67,1.96,0,,,0,,13,11,135,0,6,2.22,153
Nithesh B R,Bengaluru Bulls,0,0,0,0,0,1,0,0,0,1,1,0,0,2,0,0,33.0,0,2,3,1,0.0,0.0,0.5,0,,,0,,0,0,1,0,0,0.5,1
Nitin Madane,U Mumba,0,0,6,4,3,8,165,0,42,5,5,0,123,37,34,181,12.0,385,37,42,173,4.46,81.3,0.22,0,,,0,,72,132,8,0,1,4.68,173
Nitin More,Puneri Paltan,1,0,0,0,0,19,0,0,0,19,19,0,0,40,0,0,32.0,0,22,59,19,0.0,0.0,0.86,0,,,0,,0,0,19,0,1,0.86,19
Rahul Chaudhari,Tamil Thalaivas,0,0,42,25,5,61,1039,0,172,56,56,0,867,151,38,952,27.0,2268,150,207,1100,6.93,79.63,0.41,0,,,0,,462,854,61,0,9,7.33,1100
Rajaguru Subramanian,Telugu Titans,0,0,0,0,3,54,1,0,1,51,51,0,0,96,0,6,35.0,7,46,147,55,0.02,85.71,1.17,0,,,0,,1,0,54,0,9,1.2,55
Rajesh Mondal,Puneri Paltan,0,0,1,7,1,10,260,0,22,9,9,0,238,47,27,369,16.0,784,89,56,270,2.92,74.11,0.11,0,,,0,,203,212,10,0,2,3.03,270
Rajesh Narwal,U.P. Yoddhas,3,0,4,12,8,113,285,0,56,105,105,0,229,186,30,365,36.0,736,96,291,398,2.97,80.03,1.18,0,,,0,,147,224,113,0,13,4.15,398
Raju Choudhary,Jaipur Pink Panthers,0,0,0,0,0,23,0,0,0,23,23,0,0,47,0,0,33.0,0,23,70,23,0.0,0.0,1.0,0,,,0,,0,0,23,0,1,1.0,23
Rakesh Kumar,Telugu Titans,1,0,3,1,6,74,186,0,38,68,68,0,148,83,33,258,45.0,493,55,151,260,3.38,85.6,1.35,0,,,0,,71,164,74,0,7,4.73,260
Ravi Dalal,Patna Pirates,0,0,3,6,0,6,173,0,48,6,6,0,125,31,31,207,16.0,434,38,37,179,4.55,79.26,0.16,0,,,0,,90,136,6,0,1,4.71,179
Rishank Devadiga,U.P. Yoddha,0,0,11,25,2,47,625,0,138,45,45,0,487,103,37,513,30.0,1336,122,148,672,5.12,75.45,0.39,0,,,0,,328,495,47,0,12,5.51,672
Rohit Rana,Telugu Titans,7,0,0,0,5,136,2,0,1,131,131,0,1,221,7,9,37.0,15,82,352,138,0.02,66.67,1.66,0,,,0,,5,1,136,0,2,1.68,138
Rupesh Tomar,Telugu Titans,0,0,0,0,3,14,5,0,0,11,11,0,5,31,24,9,26.0,17,15,42,19,0.33,76.47,0.93,0,,,0,,4,4,14,0,0,1.27,19
Sachin Khambe,Bengal Warriors,2,0,0,0,6,46,5,0,1,40,40,0,4,70,28,11,36.0,18,22,110,51,0.23,88.89,2.09,0,,,0,,2,5,46,0,1,2.32,51
Santosh B.S.,U.P. Yoddha,0,0,0,1,1,9,3,0,0,8,8,0,3,14,6,11,36.0,18,9,22,12,0.33,66.67,1.0,0,,,0,,6,1,9,0,1,1.33,12
Shabeer Bappu,Tamil Thalaivas,1,0,5,5,7,23,213,0,45,16,16,0,168,69,27,360,19.0,637,74,85,236,2.88,83.05,0.31,0,,,0,,108,169,23,0,1,3.19,236
Shrikant Jadhav,U.P. Yoddhas,0,0,14,16,6,35,607,0,133,29,29,0,474,46,37,483,39.0,1287,120,75,642,5.06,74.2,0.29,0,,,0,,332,472,35,0,3,5.35,642
Shrikant Tewthia,Haryana Steelers,2,0,1,2,10,81,78,0,21,71,71,0,57,177,32,85,28.999999999999996,205,74,248,159,1.05,73.66,1.09,0,,,0,,54,66,81,0,2,2.15,159
Shyam Sha,Bengal Warriors,1,0,0,1,2,36,17,0,1,34,34,0,16,78,28,14,30.0,40,27,112,53,0.63,62.5,1.33,0,,,0,,15,11,36,0,2,1.96,53
Somvir Shekhar,Puneri Paltan,4,0,0,0,4,86,1,0,0,82,82,0,1,169,33,1,33.0,3,61,251,87,0.02,66.67,1.41,0,,,0,,1,1,86,0,8,1.43,87
Sukesh Hegde,Gujarat Giants,0,0,1,18,2,16,471,0,107,14,14,0,364,90,31,590,13.0,1130,116,104,487,4.06,83.45,0.14,0,,,0,,187,353,16,0,4,4.2,487
Surjeet Narwal,Bengal Warriors,0,0,7,4,2,14,160,0,7,12,12,0,153,20,33,190,38.0,405,31,32,174,5.16,79.75,0.45,0,,,0,,82,133,14,0,4,5.61,174
Surjeet Singh,Tamil Thalaivas,0,0,6,3,0,8,176,0,66,8,8,0,110,25,32,170,24.0,430,48,33,184,3.67,71.63,0.17,0,,,0,,122,138,8,0,1,3.83,184
Vikash Jaglan,Haryana Steelers,0,0,0,2,1,41,43,0,19,40,40,0,24,76,22,70,34.0,125,49,116,84,0.88,78.4,0.84,0,,,0,,27,28,41,0,2,1.71,84
Vishal Mane,Patna Pirates,8,0,0,0,9,203,1,0,1,194,194,0,0,349,0,2,36.0,5,135,543,204,0.01,40.0,1.5,0,,,0,,3,0,203,0,10,1.51,204
Wazir Singh,Haryana Steelers,0,0,9,7,4,22,278,0,58,18,18,0,220,36,36,273,33.0,618,47,54,300,5.91,79.94,0.47,0,,,0,,124,221,22,0,9,6.38,300
Sunil Jaipal,Patna Pirates,1,0,0,4,9,38,87,0,19,29,29,0,68,41,26,122,41.0,239,38,70,125,2.29,77.41,1.0,0,,,0,,54,63,38,0,5,3.29,125
Sandeep Narwal,U.P. Yoddhas,18,0,1,10,30,360,285,0,49,330,330,0,236,360,26,505,48.0,839,156,690,645,1.83,86.17,2.31,0,,,0,,116,218,360,2,33,4.13,645
Maninder Singh,Bengal Warriors,0,0,63,42,1,13,1231,0,244,12,12,0,987,50,48,619,19.0,2001,122,62,1244,10.09,78.81,0.11,0,,,0,,424,958,13,0,3,10.2,1244
Md Aruduzzaman,U Mumba,0,0,0,0,0,0,2,0,0,0,0,0,2,0,50,1,0.0,4,6,0,2,0.33,75.0,0.0,0,,,0,,1,2,0,0,0,0.33,2
Surender Nada,Haryana Steelers,21,0,0,0,20,278,24,0,6,258,258,0,18,288,18,70,47.0,96,102,546,302,0.24,90.62,2.73,0,,,0,,9,17,278,0,16,2.96,302
Prashant Chavan,Puneri Paltan,2,0,0,0,6,56,1,0,0,50,50,0,1,116,6,14,30.0,16,41,166,57,0.02,93.75,1.37,0,,,0,,1,1,56,0,3,1.39,57
Parmod Narwal,Haryana Steelers,0,0,0,1,3,28,21,0,4,25,25,0,17,71,21,30,26.0,61,35,96,49,0.6,70.49,0.8,0,,,0,,18,13,28,0,2,1.4,49
Gopu D,Tamil Thalaivas,1,0,0,0,7,47,3,0,0,40,40,0,3,70,25,4,36.0,12,34,110,50,0.09,66.67,1.38,0,,,0,,4,3,47,0,0,1.47,50
Prashanth Kumar Rai,Gujarat Giants,0,0,12,10,3,10,500,0,136,7,7,0,364,46,43,341,13.0,908,123,53,510,4.07,80.18,0.08,0,,,0,,180,387,10,0,10,4.15,510
Pawan Kadian,Puneri Paltan,0,0,5,4,0,2,282,0,61,2,2,0,221,35,31,292,5.0,665,75,37,284,3.76,75.34,0.03,0,,,0,,164,209,2,0,2,3.79,284
Ravinder Pahal,Gujarat Giants,23,0,0,0,19,339,14,0,7,320,320,0,7,406,14,42,44.0,58,124,726,353,0.11,86.21,2.73,0,,,0,,8,8,339,0,12,2.85,353
Rakesh Kumar,Haryana Steelers,2,0,0,0,3,49,1,0,0,46,46,0,1,149,6,14,24.0,16,49,195,50,0.02,93.75,1.0,0,,,0,,1,1,49,0,2,1.02,50
Samarjeet Singh,Jaipur Pink Panthers,0,0,0,0,3,19,3,0,1,16,16,0,2,27,7,19,37.0,28,22,43,22,0.14,75.0,0.86,0,,,0,,7,2,19,0,0,1.0,22
Ran Singh,Tamil Thalaivas,5,0,0,3,17,274,104,0,42,257,257,0,62,308,31,120,45.0,242,142,565,378,0.73,80.99,1.93,0,,,0,,46,76,274,2,5,2.66,378
Girish Maruti Ernak,Gujarat Giants,24,0,0,1,16,359,10,0,7,343,343,0,3,461,4,59,43.0,69,143,804,369,0.07,89.86,2.51,0,,,0,,7,3,359,0,12,2.58,369
D. SURESH KUMAR,Patna Pirates,6,0,0,0,12,103,0,0,0,91,91,0,0,130,0,0,41.0,1,59,221,103,0.0,0.0,1.75,0,,,0,,1,0,103,0,2,1.75,103
Mahendra Rajput,Gujarat Giants,0,0,4,13,3,20,294,0,61,17,17,0,233,49,37,204,26.0,581,94,66,314,3.13,72.46,0.21,0,,,0,,160,217,20,0,1,3.34,314
Bajirao Hodage,Patna Pirates,2,0,0,0,5,95,0,0,0,90,90,0,0,156,0,5,37.0,5,61,246,95,0.0,100.0,1.56,0,,,0,,0,0,95,0,6,1.56,95
Sachin Shingade,Haryana Steelers,5,0,0,0,10,119,0,0,0,109,109,0,0,172,0,2,39.0,3,75,281,119,0.0,66.67,1.59,0,,,0,,1,0,119,0,1,1.59,119
Vijendra Singh,Telugu Titans,2,0,0,0,1,20,0,0,0,19,19,0,0,25,0,0,43.0,0,8,44,20,0.0,0.0,2.5,0,,,0,,0,0,20,0,1,2.5,20
Preetam Chhillar,Puneri Paltan,0,0,0,1,0,30,15,0,3,30,30,0,12,76,13,50,28.000000000000004,71,58,106,45,0.26,83.1,0.52,0,,,0,,12,9,30,0,3,0.78,45
Sagar Khatale,Puneri Paltan,0,0,0,0,0,14,0,0,0,14,14,0,0,25,0,0,36.0,0,12,39,14,0.0,0.0,1.17,0,,,0,,0,0,14,0,0,1.17,14
Swapnil Shinde,Puneri Paltan,0,0,0,0,0,21,0,0,0,21,21,0,0,53,0,0,28.000000000000004,0,21,74,21,0.0,0.0,1.0,0,,,0,,0,0,21,0,0,1.0,21
PRADEEP KUMAR,U Mumba,0,0,1,2,1,2,24,0,3,1,1,0,21,10,40,19,9.0,48,10,11,26,2.4,79.17,0.2,0,,,0,,10,19,2,0,0,2.6,26
Vinoth Kumar,Telugu Titans,0,0,0,0,0,0,30,0,7,0,0,0,23,6,27,36,0.0,94,17,6,30,1.76,64.89,0.0,0,,,0,,33,25,0,0,0,1.76,30
Suresu Kumar,U Mumba,0,0,0,0,0,4,31,0,4,4,4,0,27,17,30,31,19.0,86,21,21,35,1.48,66.28,0.19,0,,,0,,29,26,4,0,0,1.67,35
Deepak Dahiya,Haryana Steelers,0,0,2,8,1,8,181,0,22,7,7,0,159,19,28,242,27.0,504,53,26,189,3.42,76.19,0.15,0,,,0,,120,142,8,0,1,3.57,189
Parveen Jangra,Bengal Warriors,0,0,0,0,0,5,1,0,0,5,5,0,1,11,11,8,31.0,9,6,16,6,0.17,100.0,0.83,0,,,0,,0,1,5,0,0,1.0,6
Vikas kale,Gujarat Giants,4,0,0,0,8,99,0,0,0,91,91,0,0,202,0,11,31.0,12,62,293,99,0.0,91.67,1.6,0,,,0,,1,0,99,0,0,1.6,99
Kedar Lal,Bengal Warriors,0,0,0,1,0,1,12,0,3,1,1,0,9,3,16,25,25.0,43,10,4,13,1.2,74.42,0.1,0,,,0,,11,7,1,0,0,1.3,13
Deepak Dhull,Patna Pirates,1,0,0,0,1,12,1,0,1,11,11,0,0,22,0,0,33.0,2,10,33,13,0.1,0.0,1.2,0,,,0,,2,0,12,0,0,1.3,13
Dinesh Kumar,Bengal Warriors,0,0,0,0,0,0,19,0,3,0,0,0,16,3,18,48,0.0,93,8,3,19,2.38,69.89,0.0,0,,,0,,28,17,0,0,1,2.38,19
DEEPAK KUMAR,Bengal Warriors,1,0,0,0,2,9,0,0,0,7,7,0,0,20,0,1,26.0,2,7,27,9,0.0,50.0,1.29,0,,,0,,1,0,9,0,1,1.29,9
Vijin Thangadurai,Gujarat Giants,0,0,0,0,5,36,0,0,0,31,31,0,0,86,0,3,26.0,5,62,117,36,0.0,60.0,0.58,0,,,0,,2,0,36,0,1,0.58,36
Sonu Narwal,Puneri Paltan,0,0,1,3,0,0,138,0,26,0,0,0,112,11,39,97,0.0,294,33,11,138,4.18,72.45,0.0,0,,,0,,81,116,0,0,0,4.18,138
C. Arun,Tamil Thalaivas,3,0,0,0,16,121,5,0,3,105,105,0,2,225,6,29,32.0,36,105,330,126,0.05,86.11,1.15,0,,,0,,5,2,121,0,1,1.2,126
Rohit Prajapat,Jaipur Pink Panthers,0,0,0,0,0,1,0,0,0,1,1,0,0,1,0,7,50.0,10,3,2,1,0.0,70.0,0.33,0,,,0,,3,0,1,0,0,0.33,1
Joginder Narwal,Haryana Steelers,2,0,0,0,13,210,5,0,2,197,197,0,3,265,38,4,43.0,8,109,462,215,0.05,87.5,1.93,0,,,0,,1,3,210,0,18,1.97,215
Ashish Chhokar,Haryana Steelers,0,0,0,1,0,4,21,0,5,4,4,0,16,5,20,34,44.0,65,12,9,25,1.75,72.31,0.33,0,,,0,,18,13,4,0,0,2.08,25
Pardeep Narwal,U.P. Yoddhas,0,0,79,73,2,9,1568,0,210,7,7,0,1358,38,45,831,16.0,2639,153,45,1577,10.25,76.2,0.06,0,,,0,,628,1180,9,0,4,10.31,1577
kazuhiro Takano,Jaipur Pink Panthers,0,0,0,0,0,0,1,0,0,0,0,0,1,0,100,0,0.0,1,2,0,1,0.5,100.0,0.0,0,,,0,,0,1,0,0,0,0.5,1
Mohammad Maghsoudlou,Telugu Titans,0,0,0,0,0,1,14,0,4,1,1,0,10,1,18,9,50.0,50,18,2,15,0.78,36.0,0.06,0,,,0,,32,9,1,0,0,0.83,15
Adinath Gavali,Bengaluru Bulls,0,0,0,0,0,1,0,0,0,1,1,0,0,5,0,0,17.0,0,1,6,1,0.0,0.0,1.0,0,,,0,,0,0,1,0,0,1.0,1
Ashish Sangwan,U Mumba,4,0,0,0,17,136,50,0,26,119,119,0,24,208,19,129,36.0,205,99,327,186,0.51,81.95,1.37,0,,,0,,37,39,136,0,1,1.88,186
Rakesh Narwal,Gujarat Giants,0,0,4,7,2,12,186,0,46,10,10,0,140,40,33,193,20.0,408,59,50,198,3.15,80.64,0.2,0,,,0,,79,136,12,0,0,3.36,198
Sandeep Malik,Bengaluru Bulls,0,0,0,0,1,2,0,0,0,1,1,0,0,0,0,0,100.0,0,1,1,2,0.0,0.0,2.0,0,,,0,,0,0,2,0,0,2.0,2
Sunil ,Tamil Thalaivas,2,0,0,0,7,105,4,0,2,98,98,0,2,144,15,8,40.0,13,63,242,109,0.06,76.92,1.67,0,,,0,,3,2,105,0,8,1.73,109
Varinder Singh,Patna Pirates,0,0,0,0,0,5,0,0,0,5,5,0,0,13,0,0,28.000000000000004,0,8,18,5,0.0,0.0,0.62,0,,,0,,0,0,5,0,1,0.62,5
Sunny ,Patna Pirates,0,0,0,0,0,0,1,0,1,0,0,0,0,1,0,7,0.0,11,3,1,1,0.33,63.64,0.0,0,,,0,,4,0,0,0,0,0.33,1
Deepak Narwal,Patna Pirates,0,0,10,6,1,13,353,0,122,12,12,0,231,37,33,326,24.0,813,93,49,366,3.8,73.43,0.14,0,,,0,,216,271,13,0,2,3.94,366
Amit Hooda,Tamil Thalaivas,14,0,0,0,20,268,11,0,6,248,248,0,5,255,7,40,49.0,56,103,503,279,0.11,78.57,2.6,0,,,0,,12,4,268,0,4,2.71,279
Vinod Kumar,Telugu Titans,1,0,0,0,0,48,0,0,0,48,48,0,0,80,0,1,38.0,1,27,128,48,0.0,100.0,1.78,0,,,0,,0,0,48,0,0,1.78,48
Rohit Chaudhary,U.P. Yoddha,0,0,1,6,0,3,93,0,15,3,3,0,78,25,22,148,11.0,294,38,28,96,2.45,72.11,0.08,0,,,0,,82,64,3,0,4,2.53,96
Sachin Kumar,U.P. Yoddha,3,0,0,0,5,56,28,0,2,51,51,0,26,90,20,75,36.0,115,49,141,84,0.57,85.22,1.14,0,,,0,,17,23,56,1,2,1.71,84
K. Prapanjan,Gujarat Giants,0,0,10,8,0,7,427,0,85,7,7,0,342,50,35,394,12.0,954,103,57,434,4.15,76.1,0.07,0,,,0,,228,332,7,0,0,4.21,434
Anoop E.V ,U Mumba,0,0,0,0,0,2,0,0,0,2,2,0,0,9,0,0,18.0,0,3,11,2,0.0,0.0,0.67,0,,,0,,0,0,2,0,0,0.67,2
G.s.Manikandan ,Dabang Delhi K.C.,0,0,0,0,1,11,0,0,0,10,10,0,0,48,0,0,17.0,1,20,58,11,0.0,0.0,0.55,0,,,0,,1,0,11,0,0,0.55,11
Inderpal Bishnoi,Dabang Delhi K.C.,0,0,0,0,0,0,1,0,0,0,0,0,1,1,33,0,0.0,3,2,1,1,0.5,33.33,0.0,0,,,0,,2,1,0,0,0,0.5,1
Sandeep Tomar,Dabang Delhi K.C.,0,0,0,0,0,0,2,0,0,0,0,0,2,0,22,4,0.0,9,3,0,2,0.67,66.67,0.0,0,,,0,,3,2,0,0,1,0.67,2
Vinoth Paulyas,Patna Pirates,0,0,0,0,0,0,2,0,0,0,0,0,2,1,20,5,0.0,10,4,1,2,0.5,70.0,0.0,0,,,0,,3,2,0,0,0,0.5,2
Gopalappa Thimarayappa,U Mumba,0,0,0,0,0,0,0,0,0,0,0,0,0,0,0,0,0.0,1,1,0,0,0.0,0.0,0.0,0,,,0,,1,0,0,0,0,0.0,0
Vinod Atyalkar,U Mumba,0,0,0,0,0,0,0,0,0,0,0,0,0,1,0,0,0.0,2,2,1,0,0.0,0.0,0.0,0,,,0,,2,0,0,0,0,0.0,0
Onkar Jadhav,U Mumba,0,0,0,0,0,0,0,0,0,0,0,0,0,0,0,0,0.0,1,1,0,0,0.0,0.0,0.0,0,,,0,,1,0,0,0,0,0.0,0
Amit Rathi,Gujarat Giants,0,0,0,1,2,6,46,0,9,4,4,0,37,8,30,50,33.0,110,16,12,52,2.88,75.45,0.38,0,,,0,,27,33,6,0,0,3.25,52
Sachin Vittala,Gujarat Giants,1,0,0,1,2,31,14,0,3,29,29,0,11,55,30,20,35.0,37,33,84,45,0.42,83.78,0.94,0,,,0,,6,11,31,0,3,1.36,45
Manoj Dhull,Puneri Paltan,0,0,0,0,1,24,0,0,0,23,23,0,0,50,0,0,32.0,0,27,73,24,0.0,0.0,0.89,0,,,0,,0,0,24,0,1,0.89,24
Surender Singh,U.P. Yoddha,0,0,2,4,0,9,146,0,62,9,9,0,84,44,31,128,17.0,334,51,53,155,2.86,69.46,0.18,0,,,0,,102,104,9,0,1,3.04,155
T.Prasad ,Telugu Titans,0,0,0,0,0,5,0,0,0,5,5,0,0,7,0,2,42.0,5,9,12,5,0.0,40.0,0.56,0,,,0,,3,0,5,0,0,0.56,5
Isca Antony,Telugu Titans,0,0,0,0,0,4,11,0,0,4,4,0,11,7,36,10,36.0,28,9,11,15,1.22,71.43,0.44,0,,,0,,8,10,4,0,0,1.67,15
Jishnu ,Telugu Titans,0,0,0,0,0,1,0,0,0,1,1,0,0,5,0,0,17.0,0,3,6,1,0.0,0.0,0.33,0,,,0,,0,0,1,0,0,0.33,1
Ravi Kumar,Haryana Steelers,9,0,0,0,23,214,1,0,1,191,191,0,0,325,0,40,37.0,45,137,516,215,0.01,88.89,1.56,0,,,0,,5,0,214,0,2,1.57,215
Ravit Kumar,Telugu Titans,0,0,0,0,0,1,1,0,0,1,1,0,1,10,100,0,9.0,1,3,11,2,0.33,100.0,0.33,0,,,0,,0,1,1,0,0,0.67,2
Tushar Patil,Puneri Paltan,0,0,0,5,0,4,135,0,35,4,4,0,100,32,33,123,11.0,320,53,36,139,2.55,70.94,0.08,0,,,0,,93,104,4,0,3,2.62,139
Sanjay Kumar,Puneri Paltan,0,0,0,2,0,1,15,0,3,1,1,0,12,8,19,23,11.0,47,8,9,16,1.88,68.09,0.12,0,,,0,,15,9,1,0,0,2.0,16
Ravi v. ,Puneri Paltan,0,0,0,0,0,0,8,0,2,0,0,0,6,0,38,4,0.0,13,2,0,8,4.0,69.23,0.0,0,,,0,,4,5,0,0,0,4.0,8
Yogesh Hooda,Puneri Paltan,0,0,0,0,0,10,35,0,10,10,10,0,25,19,24,56,34.0,121,21,29,45,1.67,70.25,0.48,0,,,0,,36,29,10,0,1,2.14,45
Harvinder Singh,Puneri Paltan,0,0,0,0,1,8,0,0,0,7,7,0,0,11,0,1,39.0,2,4,18,8,0.0,50.0,2.0,0,,,0,,1,0,8,0,0,2.0,8
Anil Singh,Puneri Paltan,0,0,0,0,0,0,0,0,0,0,0,0,0,6,0,0,0.0,0,2,6,0,0.0,0.0,0.0,0,,,0,,0,0,0,0,0,0.0,0
Sandeep Kandola,Gujarat Giants,8,0,0,0,6,107,11,0,3,101,101,0,8,106,39,6,49.0,18,46,207,118,0.24,72.22,2.33,0,,,0,,5,7,107,0,3,2.57,118
Hadi Oshtorak,Gujarat Giants,3,0,0,0,17,127,25,0,12,110,110,0,13,189,15,49,37.0,72,93,299,152,0.27,83.33,1.37,0,,,0,,12,11,127,0,19,1.63,152
Meraj Sheykh,Telugu Titans,0,0,6,15,6,54,350,0,52,48,48,0,298,101,29,437,32.0,886,99,149,404,3.54,78.44,0.55,0,,,0,,191,258,54,0,3,4.08,404
Kuldeep Singh,Patna Pirates,6,0,0,2,20,123,59,0,28,103,103,0,31,159,17,137,39.0,234,66,262,182,0.89,75.21,1.86,0,,,0,,58,39,123,0,12,2.76,182
Michal Spiczko,Bengaluru Bulls,0,0,0,0,0,0,0,0,0,0,0,0,0,1,0,0,0.0,0,1,1,0,0.0,0.0,0.0,0,,,0,,0,0,0,0,0,0.0,0
Sulieman Kabir,U.P. Yoddha,0,0,0,0,0,0,0,0,0,0,0,0,0,0,0,1,0.0,3,2,0,0,0.0,33.33,0.0,0,,,0,,2,0,0,0,0,0.0,0
Fazel Atrachali,Gujarat Giants,26,0,0,0,24,424,4,0,2,400,400,0,2,321,3,55,55.00000000000001,63,146,721,428,0.03,90.48,2.9,0,,,0,,6,2,424,0,26,2.93,428
VIJAY MALIK,Patna Pirates,0,0,0,0,0,0,5,0,0,0,0,0,5,0,18,9,0.0,22,7,0,5,0.71,59.09,0.0,0,,,0,,9,4,0,0,0,0.71,5
Rohit Baliyan,Telugu Titans,0,0,3,6,2,29,275,0,102,27,27,0,173,69,36,285,28.000000000000004,635,70,96,304,3.93,80.94,0.41,0,,,0,,121,229,29,0,3,4.34,304
Jay Bohara,Dabang Delhi K.C.,0,0,0,0,0,0,2,0,0,0,0,0,2,0,100,0,0.0,1,1,0,2,2.0,100.0,0.0,0,,,0,,0,1,0,0,0,2.0,2
Selvamani K,Haryana Steelers,0,0,2,7,0,6,154,0,44,6,6,0,110,23,31,173,21.0,364,58,29,160,2.66,78.57,0.1,0,,,0,,78,113,6,0,0,2.76,160
David Mosambayi,Haryana Steelers,0,0,0,0,0,0,6,0,2,0,0,0,4,1,15,6,0.0,13,7,1,6,0.86,61.54,0.0,0,,,0,,5,2,0,0,0,0.86,6
Amit Kumar,Telugu Titans,0,0,0,0,2,15,10,0,6,13,13,0,4,24,7,63,35.0,85,20,37,25,0.5,81.18,0.75,0,,,0,,16,6,15,0,0,1.25,25
Vineet Sharma,Tamil Thalaivas,0,0,0,0,2,26,42,0,18,24,24,0,24,53,16,139,31.0,218,43,77,68,0.98,79.82,0.6,0,,,0,,44,35,26,0,1,1.58,68
Arvind Baliyan,Patna Pirates,0,0,0,0,0,0,0,0,0,0,0,0,0,5,0,0,0.0,0,2,5,0,0.0,0.0,0.0,0,,,0,,0,0,0,0,0,0.0,0
Jasmer Singh,Patna Pirates,0,0,0,0,0,0,0,0,0,0,0,0,0,0,0,1,0.0,2,2,0,0,0.0,50.0,0.0,0,,,0,,1,0,0,0,0,0.0,0
Narendar Kumar,Bengal Warriors,0,0,0,0,0,0,0,0,0,0,0,0,0,3,0,1,0.0,2,3,3,0,0.0,50.0,0.0,0,,,0,,1,0,0,0,0,0.0,0
Umesh Mhatre,Puneri Paltan,0,0,0,0,2,9,19,0,4,7,7,0,15,11,24,36,39.0,67,13,18,28,1.46,77.61,0.69,0,,,0,,15,16,9,0,1,2.15,28
Satish Kumar,Bengaluru Bulls,0,0,0,0,0,0,0,0,0,0,0,0,0,4,0,0,0.0,0,2,4,0,0.0,0.0,0.0,0,,,0,,0,0,0,0,0,0.0,0
Krushna Madane,Telugu Titans,1,0,0,0,1,27,1,0,0,26,26,0,1,35,6,14,43.0,17,19,61,28,0.05,88.24,1.42,0,,,0,,2,1,27,0,1,1.47,28
Deepak Kumar,Haryana Steelers,0,0,0,1,1,15,9,0,0,14,14,0,9,25,16,27,36.0,45,20,39,24,0.45,75.56,0.75,0,,,0,,11,7,15,0,0,1.2,24
Anil Nimbolkar,Dabang Delhi K.C.,0,0,1,1,2,4,15,0,3,2,2,0,12,7,24,16,22.0,38,6,9,19,2.5,65.79,0.67,0,,,0,,13,9,4,0,0,3.17,19
Gnanasekaran M ,Dabang Delhi K.C.,0,0,0,0,1,2,5,0,2,1,1,0,3,14,21,6,7.000000000000001,14,8,15,7,0.62,64.29,0.25,0,,,0,,5,3,2,0,0,0.88,7
Shashank Wankhede,Telugu Titans,0,0,0,0,0,2,0,0,0,2,2,0,0,13,0,0,13.0,1,5,15,2,0.0,0.0,0.4,0,,,0,,1,0,2,0,0,0.4,2
Jagdeesha K.K,Jaipur Pink Panthers,0,0,0,0,0,5,0,0,0,5,5,0,0,8,0,0,38.0,0,7,13,5,0.0,0.0,0.71,0,,,0,,0,0,5,0,0,0.71,5
Anil Patil,Jaipur Pink Panthers,0,0,0,0,0,0,8,0,4,0,0,0,4,3,32,8,0.0,19,5,3,8,1.6,73.68,0.0,0,,,0,,5,6,0,0,0,1.6,8
Rahul Kumar,Telugu Titans,0,0,0,0,2,22,0,0,0,20,20,0,0,72,0,1,22.0,1,30,92,22,0.0,100.0,0.73,0,,,0,,0,0,22,0,0,0.73,22
Sandeep Dhull,Telugu Titans,18,0,0,0,22,291,1,0,1,269,269,0,0,344,0,3,44.0,5,102,613,292,0.01,60.0,2.85,0,,,0,,2,0,291,0,5,2.86,292
Nilesh Salunke,Telugu Titans,0,0,5,10,2,15,316,0,122,13,13,0,194,50,32,356,21.0,761,80,63,331,3.95,78.32,0.19,0,,,0,,165,240,15,0,6,4.14,331
Felix Opana,Bengal Warriors,0,0,0,0,0,0,0,0,0,0,0,0,0,0,0,0,0.0,1,1,0,0,0.0,0.0,0.0,0,,,0,,1,0,0,0,0,0.0,0
Navjot Singh,Dabang Delhi K.C.,0,0,0,0,0,1,0,0,0,1,1,0,0,2,0,0,33.0,0,1,3,1,0.0,0.0,1.0,0,,,0,,0,0,1,0,0,1.0,1
Sandeep,Gujarat Giants,0,0,0,0,3,21,0,0,0,18,18,0,0,36,0,1,33.0,3,20,54,21,0.0,33.33,1.05,0,,,0,,2,0,21,0,0,1.05,21
Abolfazel Maghsodlo,Gujarat Giants,0,0,0,3,1,8,147,0,34,7,7,0,113,14,33,153,33.0,362,50,21,155,2.94,75.14,0.16,0,,,0,,90,119,8,0,4,3.1,155
Hadi Tajik,U.P. Yoddhas,0,0,0,0,2,24,5,0,2,22,22,0,3,47,17,6,32.0,18,26,69,29,0.19,50.0,0.92,0,,,0,,9,3,24,1,2,1.12,29
Khomsan Thongkham,Haryana Steelers,0,0,0,0,0,0,0,0,0,0,0,0,0,0,0,0,0.0,2,2,0,0,0.0,0.0,0.0,0,,,0,,2,0,0,0,0,0.0,0
Ravinandan G.M ,Dabang Delhi K.C.,0,0,0,0,0,1,0,0,0,1,1,0,0,0,0,0,100.0,0,1,1,1,0.0,0.0,1.0,0,,,0,,0,0,1,0,0,1.0,1
Sushil Bhosale,Dabang Delhi K.C.,0,0,0,0,0,2,0,0,0,2,2,0,0,8,0,0,20.0,0,2,10,2,0.0,0.0,1.0,0,,,0,,0,0,2,0,0,1.0,2
Manpreet Singh,Patna Pirates,0,0,0,0,0,5,24,0,10,5,5,0,14,8,19,71,38.0,107,13,13,29,1.85,85.05,0.38,0,,,0,,16,20,5,0,2,2.23,29
Lo Wei,Jaipur Pink Panthers,0,0,0,0,0,0,0,0,0,0,0,0,0,2,0,3,0.0,3,2,2,0,0.0,100.0,0.0,0,,,0,,0,0,0,0,0,0.0,0
Anil Kumar,U.P. Yoddhas,0,0,0,0,5,93,4,0,2,88,88,0,2,135,8,27,39.0,36,62,223,97,0.06,83.33,1.5,0,,,0,,6,3,93,0,3,1.56,97
Sanju ,Telugu Titans,0,0,0,0,0,1,0,0,0,1,1,0,0,5,0,0,17.0,1,4,6,1,0.0,0.0,0.25,0,,,0,,1,0,1,0,0,0.25,1
Virender Singh,Telugu Titans,0,0,0,1,0,1,14,0,4,1,1,0,10,0,25,10,100.0,28,7,1,15,2.0,60.71,0.14,0,,,0,,11,7,1,0,0,2.14,15
Somvir ,Telugu Titans,0,0,0,0,1,21,1,0,1,20,20,0,0,48,0,1,28.999999999999996,2,16,68,22,0.06,50.0,1.31,0,,,0,,1,0,21,0,1,1.38,22
Pravesh Attri,Bengaluru Bulls,0,0,0,0,0,0,1,0,0,0,0,0,1,1,50,0,0.0,2,1,1,1,1.0,50.0,0.0,0,,,0,,1,1,0,0,0,1.0,1
Nirbhay Narwal,Bengaluru Bulls,0,0,0,0,0,1,1,0,0,1,1,0,1,2,33,2,33.0,3,2,3,2,0.5,100.0,0.5,0,,,0,,0,1,1,0,0,1.0,2
Hardeep Duhan,Bengaluru Bulls,0,0,0,0,0,1,0,0,0,1,1,0,0,3,0,0,25.0,0,1,4,1,0.0,0.0,1.0,0,,,0,,0,0,1,0,0,1.0,1
Pawan Sehrawat,Gujarat Giants,1,0,49,29,7,50,987,0,198,43,43,0,789,89,52,320,33.0,1484,105,132,1037,9.4,73.11,0.48,0,,,0,,399,765,50,0,6,9.88,1037
Nitin Tomar,U.P. Yoddhas,1,0,14,11,4,38,491,0,128,34,34,0,363,97,39,450,26.0,1047,91,131,529,5.4,82.43,0.42,0,,,0,,184,413,38,0,2,5.81,529
Surjeet Singh,Tamil Thalaivas,29,0,0,0,24,348,15,0,3,324,324,0,12,382,6,145,46.0,162,127,706,363,0.12,95.06,2.74,0,,,0,,8,9,348,0,21,2.86,363
Mahender Singh Dhaka,Haryana Steelers,0,0,0,0,0,0,0,0,0,0,0,0,0,2,0,0,0.0,0,2,2,0,0.0,0.0,0.0,0,,,0,,0,0,0,0,0,0.0,0
DARSHAN ,Puneri Paltan,0,0,1,2,3,11,91,0,12,8,8,0,79,37,27,112,18.0,246,40,45,102,2.28,72.76,0.28,0,,,0,,67,67,11,0,1,2.55,102
Rohit Kumar,Gujarat Giants,1,0,26,16,2,47,683,0,144,45,45,0,539,83,38,603,35.0,1473,101,128,730,6.76,78.89,0.47,0,,,0,,311,559,47,1,3,7.23,730
Odhiambo Ogak,Patna Pirates,0,0,0,0,0,0,0,0,0,0,0,0,0,0,0,0,0.0,0,0,0,0,,0.0,,0,,,0,,0,0,0,0,0,,0
Phonchoo Tin,Haryana Steelers,0,0,0,0,0,0,1,0,0,0,0,0,1,0,20,2,0.0,5,4,0,1,0.25,60.0,0.0,0,,,0,,2,1,0,0,0,0.25,1
Sagar Krishna,U.P. Yoddha,5,0,0,0,8,77,2,0,1,69,69,0,1,111,5,17,38.0,21,72,180,79,0.03,85.71,1.07,0,,,0,,3,1,77,0,0,1.1,79
Mahender Reddy,Telugu Titans,0,0,0,0,0,0,0,0,0,0,0,0,0,0,0,0,0.0,0,1,0,0,0.0,0.0,0.0,0,,,0,,0,0,0,0,0,0.0,0
Parvesh Bhainswal,Gujarat Giants,19,0,0,0,31,302,4,0,4,271,271,0,0,277,0,4,49.0,8,122,548,306,0.03,50.0,2.48,0,,,0,,4,0,302,0,8,2.51,306
Sanket Chavan,Tamil Thalaivas,0,0,0,0,0,15,0,0,0,15,15,0,0,24,0,2,38.0,2,13,39,15,0.0,100.0,1.15,0,,,0,,0,0,15,0,0,1.15,15
Ajay Singh,Bengaluru Bulls,0,0,0,0,0,1,0,0,0,1,1,0,0,5,0,0,17.0,0,1,6,1,0.0,0.0,1.0,0,,,0,,0,0,1,0,0,1.0,1
Akshay Jadhav,Puneri Paltan,2,0,0,0,3,25,37,0,13,22,22,0,24,21,23,78,51.0,147,29,43,62,1.28,76.19,0.86,0,,,0,,35,34,25,0,0,2.14,62
Vikash Kandola,Haryana Steelers,0,0,29,22,0,20,732,0,145,20,20,0,587,58,37,652,26.0,1579,101,78,752,7.25,78.21,0.2,0,,,0,,344,583,20,0,3,7.45,752
Nitin Kumar,U Mumba,0,0,0,0,0,0,1,0,1,0,0,0,0,2,50,0,0.0,2,1,2,1,1.0,50.0,0.0,0,,,0,,1,1,0,0,0,1.0,1
Sunil Kumar,Gujarat Giants,16,0,0,0,17,281,5,0,0,264,264,0,5,265,4,114,50.0,121,114,529,286,0.04,98.35,2.46,0,,,0,,2,5,281,0,12,2.51,286
Dalbir ,Puneri Paltan,0,0,0,0,0,0,0,0,0,0,0,0,0,0,0,2,0.0,3,2,0,0,0.0,66.67,0.0,0,,,0,,1,0,0,0,0,0.0,0
Amit Nagar,Bengal Warriors,0,0,0,0,0,9,23,0,4,9,9,0,19,19,32,26,32.0,60,19,28,32,1.21,75.0,0.47,0,,,0,,15,19,9,0,0,1.68,32
Athul MS,Tamil Thalaivas,0,0,0,0,0,1,148,0,54,1,1,0,94,30,35,97,3.0,317,54,31,149,2.74,65.93,0.02,0,,,0,,108,112,1,0,3,2.76,149
Vikash Kumar,U Mumba,0,0,0,0,0,0,6,0,3,0,0,0,3,4,24,7,0.0,17,6,4,6,1.0,64.71,0.0,0,,,0,,6,4,0,0,0,1.0,6
Anil Kumar,Tamil Thalaivas,0,0,0,0,5,24,1,0,0,19,19,0,1,38,10,8,33.0,10,19,57,25,0.05,90.0,1.26,0,,,0,,1,1,24,0,1,1.32,25
Vinod Kumar,Bengal Warriors,0,0,0,0,0,9,52,0,9,9,9,0,43,28,23,96,24.0,184,29,37,61,1.79,75.54,0.31,0,,,0,,45,43,9,0,0,2.1,61
Monu Goyat,U.P. Yoddhas,0,0,23,10,5,41,584,0,172,36,36,0,412,91,39,444,28.000000000000004,1234,97,127,625,6.02,74.8,0.42,0,,,0,,311,479,41,0,3,6.44,625
Ajay Kumar,Gujarat Giants,0,0,6,6,0,2,260,0,55,2,2,0,205,22,32,282,8.0,614,67,24,262,3.88,78.18,0.03,0,,,0,,134,198,2,0,4,3.91,262
Jawahar Dagar,Patna Pirates,2,0,0,0,6,56,9,0,4,50,50,0,5,108,13,18,32.0,31,46,158,65,0.2,70.97,1.22,0,,,0,,9,4,56,0,0,1.41,65
S Mahalingam,Telugu Titans,0,0,0,0,2,16,0,0,0,14,14,0,0,18,0,0,44.0,0,11,32,16,0.0,0.0,1.45,0,,,0,,0,0,16,0,0,1.45,16
Kuldeep (392) ,Bengal Warriors,0,0,0,0,0,2,0,0,0,2,2,0,0,3,0,1,40.0,3,5,5,2,0.0,33.33,0.4,0,,,0,,2,0,2,0,0,0.4,2
Patrick Muvai,Haryana Steelers,0,0,0,0,0,0,0,0,0,0,0,0,0,0,0,0,0.0,0,0,0,0,,0.0,,0,,,0,,0,0,0,0,0,,0
Farhad Milaghardan,Telugu Titans,1,0,1,0,5,79,74,0,14,74,74,0,60,129,33,88,36.0,181,62,203,153,1.19,81.77,1.27,0,,,0,,33,60,79,0,3,2.47,153
Abozar Mighani,Gujarat Giants,8,0,0,0,16,203,2,0,2,187,187,0,0,209,0,36,47.0,39,89,396,205,0.02,92.31,2.28,0,,,0,,3,0,203,1,7,2.3,205
Kim Gyung Tae,Bengaluru Bulls,0,0,0,0,0,0,0,0,0,0,0,0,0,0,0,0,0.0,1,1,0,0,0.0,0.0,0.0,0,,,0,,1,0,0,0,0,0.0,0
Yong Joo Ok,U Mumba,0,0,0,0,0,0,1,0,0,0,0,0,1,1,50,1,0.0,2,1,1,1,1.0,100.0,0.0,0,,,0,,0,1,0,0,0,1.0,1
Chan Sik Park,Tamil Thalaivas,0,0,0,0,0,0,0,0,0,0,0,0,0,3,0,0,0.0,0,1,3,0,0.0,0.0,0.0,0,,,0,,0,0,0,0,0,0.0,0
Dong Gyu Kim,Jaipur Pink Panthers,0,0,0,0,0,0,0,0,0,0,0,0,0,0,0,0,0.0,0,0,0,0,,0.0,,0,,,0,,0,0,0,0,0,,0
Young Chang Ko,U Mumba,1,0,0,0,6,26,0,0,0,20,20,0,0,71,0,0,22.0,0,40,91,26,0.0,0.0,0.65,0,,,0,,0,0,26,0,0,0.65,26
Dong Geon Lee,Gujarat Giants,0,0,2,1,1,2,127,0,57,1,1,0,70,13,38,97,7.000000000000001,258,55,14,129,2.31,75.19,0.04,0,,,0,,64,97,2,0,0,2.35,129
Ziaur Rahman,Puneri Paltan,1,0,0,0,2,32,0,0,0,30,30,0,0,61,0,0,33.0,0,34,91,32,0.0,0.0,0.94,0,,,0,,0,0,32,0,2,0.94,32
Mohammad Hossain,Gujarat Giants,0,0,0,0,0,0,0,0,0,0,0,0,0,0,0,0,0.0,0,0,0,0,,0.0,,0,,,0,,0,0,0,0,0,,0
Mohsen Maghsoudlou,U.P. Yoddhas,0,0,1,2,7,56,113,0,39,49,49,0,74,92,23,205,35.0,382,75,141,169,1.51,76.18,0.75,0,,,0,,91,86,56,0,3,2.25,169
Anand Patil,Jaipur Pink Panthers,0,0,0,3,0,0,46,0,11,0,0,0,35,8,21,74,0.0,154,26,8,46,1.77,69.48,0.0,0,,,0,,47,33,0,0,0,1.77,46
Jaideep,U.P. Yoddhas,12,0,0,0,11,187,0,0,0,176,176,0,0,258,0,14,41.0,15,89,434,187,0.0,93.33,2.1,0,,,0,,1,0,187,0,9,2.1,187
Vishnu Uthaman,Patna Pirates,0,0,0,0,0,1,0,0,0,1,1,0,0,0,0,3,100.0,7,3,1,1,0.0,42.86,0.33,0,,,0,,4,0,1,0,0,0.33,1
Lal Mohar Yadav,Puneri Paltan,0,0,0,0,0,0,0,0,0,0,0,0,0,0,0,0,0.0,0,0,0,0,0.0,0.0,0.0,0,,,0,,0,0,0,0,0,0.0,0
Bajrang ,Puneri Paltan,0,0,0,0,0,0,0,0,0,0,0,0,0,0,0,0,0.0,0,0,0,0,,0.0,,0,,,0,,0,0,0,0,0,,0
Lokesh Kaushik,Jaipur Pink Panthers,0,0,0,0,0,2,5,0,1,2,2,0,4,3,26,5,40.0,19,8,5,7,0.62,52.63,0.25,0,,,0,,9,5,2,0,0,0.88,7
Ankit Malik,Telugu Titans,0,0,0,0,0,0,0,0,0,0,0,0,0,1,0,0,0.0,0,1,1,0,0.0,0.0,0.0,0,,,0,,0,0,0,0,0,0.0,0
Shubham Ashok Palkar,Gujarat Giants,0,0,0,0,0,0,9,0,1,0,0,0,8,4,22,16,0.0,37,12,4,9,0.75,64.86,0.0,0,,,0,,13,8,0,0,0,0.75,9
Prateek ,Haryana Steelers,0,0,0,0,0,2,3,0,3,2,2,0,0,3,13,4,40.0,8,6,5,5,0.5,62.5,0.33,0,,,0,,3,1,2,0,0,0.83,5
Shiv Om,U Mumba,0,0,0,0,0,0,0,0,0,0,0,0,0,4,0,0,0.0,0,2,4,0,0.0,0.0,0.0,0,,,0,,0,0,0,0,0,0.0,0
Siddharth ,Jaipur Pink Panthers,1,0,0,0,3,27,4,0,1,24,24,0,3,44,9,22,35.0,32,21,68,31,0.19,78.12,1.29,0,,,0,,7,3,27,0,0,1.48,31
Sunil Siddhgavali,U Mumba,5,0,0,0,7,61,5,0,0,54,54,0,5,132,20,14,28.999999999999996,20,46,186,66,0.11,90.0,1.33,0,,,0,,2,4,61,0,2,1.43,66
T. Prabhakaran,Tamil Thalaivas,0,0,0,0,0,0,0,0,0,0,0,0,0,2,0,0,0.0,0,2,2,0,0.0,0.0,0.0,0,,,0,,0,0,0,0,0,0.0,0
C Kalai Arasan,Gujarat Giants,0,0,0,0,0,0,0,0,0,0,0,0,0,8,0,0,0.0,0,3,8,0,0.0,0.0,0.0,0,,,0,,0,0,0,0,0,0.0,0
Baldev Singh,Gujarat Giants,7,0,0,0,8,100,3,0,2,92,92,0,1,128,11,5,42.0,9,58,220,103,0.05,66.67,1.72,0,,,0,,3,1,100,0,3,1.78,103
Narender Hooda,Bengaluru Bulls,0,0,0,0,0,3,0,0,0,3,3,0,0,6,0,0,33.0,0,9,9,3,0.0,0.0,0.33,0,,,0,,0,0,3,0,0,0.33,3
K. Jayaseelan ,Tamil Thalaivas,0,0,0,0,0,0,0,0,0,0,0,0,0,0,0,2,0.0,3,1,0,0,0.0,66.67,0.0,0,,,0,,1,0,0,0,0,0.0,0
Kamal Kishor,Jaipur Pink Panthers,0,0,0,0,0,0,0,0,0,0,0,0,0,1,0,1,0.0,9,7,1,0,0.0,11.11,0.0,0,,,0,,8,0,0,0,0,0.0,0
Sanoj Kumar,U.P. Yoddha,0,0,0,0,0,1,2,0,0,1,1,0,2,7,100,0,12.0,2,2,8,3,1.0,100.0,0.5,0,,,0,,0,2,1,0,0,1.5,3
Anand Tomar,Haryana Steelers,0,0,0,1,0,1,26,0,6,1,1,0,20,5,48,13,17.0,44,9,6,27,2.89,77.27,0.11,0,,,0,,10,21,1,0,1,3.0,27
Sujit Maharana,Tamil Thalaivas,0,0,0,0,0,0,0,0,0,0,0,0,0,3,0,3,0.0,5,2,3,0,0.0,60.0,0.0,0,,,0,,2,0,0,0,0,0.0,0
Gulveer Singh,U.P. Yoddhas,0,0,0,0,1,2,3,0,1,1,1,0,2,1,7,3,50.0,15,6,2,5,0.5,26.67,0.33,0,,,0,,11,1,2,0,0,0.83,5
Bhavani Rajput,Tamil Thalaivas,0,0,0,2,0,0,89,0,31,0,0,0,58,15,31,78,0.0,198,39,15,89,2.28,70.2,0.0,0,,,0,,59,61,0,0,2,2.28,89
Elangeshwaran R,Telugu Titans,0,0,0,1,2,4,12,0,4,2,2,0,8,5,30,9,28.999999999999996,23,5,7,16,2.4,69.57,0.8,0,,,0,,7,7,4,0,0,3.2,16
Vipin Malik,Dabang Delhi K.C.,0,0,0,0,0,0,0,0,0,0,0,0,0,1,0,0,0.0,3,2,1,0,0.0,0.0,0.0,0,,,0,,3,0,0,0,0,0.0,0
Mohan Raman G,U Mumba,0,0,0,0,0,0,8,0,3,0,0,0,5,2,44,1,0.0,9,4,2,8,2.0,55.56,0.0,0,,,0,,4,4,0,0,0,2.0,8
Deepak Yadav,Puneri Paltan,0,0,0,0,1,8,0,0,0,7,7,0,0,17,0,1,28.999999999999996,2,7,24,8,0.0,50.0,1.14,0,,,0,,1,0,8,0,0,1.14,8
M. Thivakaran,Tamil Thalaivas,0,0,0,0,0,2,14,0,4,2,2,0,10,3,31,15,40.0,36,9,5,16,1.56,72.22,0.22,0,,,0,,10,11,2,0,0,1.78,16
Vishav Chaudhary,Gujarat Giants,0,0,0,0,0,0,2,0,1,0,0,0,1,0,9,6,0.0,11,2,0,2,1.0,63.64,0.0,0,,,0,,4,1,0,0,0,1.0,2
Ajvender Singh,U.P. Yoddha,0,0,0,0,0,1,0,0,0,1,1,0,0,2,0,1,33.0,1,2,3,1,0.0,100.0,0.5,0,,,0,,0,0,1,0,0,0.5,1
N. Shiva Ramakrishna,Jaipur Pink Panthers,0,0,0,0,1,2,0,0,0,1,1,0,0,0,0,0,100.0,0,1,1,2,0.0,0.0,2.0,0,,,0,,0,0,2,0,0,2.0,2
N. Renjith,U Mumba,0,0,0,0,2,12,0,0,0,10,10,0,0,23,0,0,30.0,0,11,33,12,0.0,0.0,1.09,0,,,0,,0,0,12,0,0,1.09,12
Rohit Kumar,U.P. Yoddha,0,0,0,0,0,1,2,0,1,1,1,0,1,20,50,0,5.0,2,7,21,3,0.29,50.0,0.14,0,,,0,,1,1,1,0,0,0.43,3
R. Sriram ,Puneri Paltan,0,0,0,0,0,1,35,0,5,1,1,0,30,7,33,31,12.0,89,15,8,36,2.33,67.42,0.07,0,,,0,,29,29,1,0,0,2.4,36
Abhishek N,Jaipur Pink Panthers,0,0,0,0,0,0,0,0,0,0,0,0,0,0,0,1,0.0,2,2,0,0,0.0,50.0,0.0,0,,,0,,1,0,0,0,0,0.0,0
Darshan J.,Tamil Thalaivas,1,0,0,0,1,60,1,0,1,59,59,0,0,107,0,2,36.0,4,38,166,61,0.03,50.0,1.58,0,,,0,,2,0,60,0,3,1.61,61
Babu M,U.P. Yoddhas,0,0,0,0,1,5,0,0,0,4,4,0,0,14,0,1,22.0,1,4,18,5,0.0,100.0,1.25,0,,,0,,0,0,5,0,0,1.25,5
Sandeep Malik,Bengal Warriors,0,0,0,0,0,0,0,0,0,0,0,0,0,3,0,0,0.0,0,1,3,0,0.0,0.0,0.0,0,,,0,,0,0,0,0,1,0.0,0
Manish ,Patna Pirates,0,0,0,0,7,37,0,0,0,30,30,0,0,33,0,0,48.0,2,40,63,37,0.0,0.0,0.92,0,,,0,,2,0,37,0,1,0.92,37
Rajesh Manokaran,Tamil Thalaivas,0,0,0,0,0,0,0,0,0,0,0,0,0,2,0,0,0.0,0,2,2,0,0.0,0.0,0.0,0,,,0,,0,0,0,0,0,0.0,0
Kuldeep Singh (732),Haryana Steelers,3,0,0,0,5,67,1,0,1,62,62,0,0,94,0,2,40.0,3,39,156,68,0.03,66.67,1.72,0,,,0,,1,0,67,0,3,1.74,68
Vikas,Haryana Steelers,0,0,0,0,2,26,0,0,0,24,24,0,0,37,0,1,39.0,2,19,61,26,0.0,50.0,1.37,0,,,0,,1,0,26,0,0,1.37,26
Yatharth ,Dabang Delhi K.C.,0,0,0,0,1,11,0,0,0,10,10,0,0,18,0,1,36.0,1,6,28,11,0.0,100.0,1.83,0,,,0,,0,0,11,0,0,1.83,11
Ajay,Haryana Steelers,0,0,0,0,0,0,1,0,1,0,0,0,0,0,0,0,0.0,1,2,0,1,0.5,0.0,0.0,0,,,0,,1,0,0,0,0,0.5,1
Rahul Choudhary,Jaipur Pink Panthers,0,0,0,0,0,1,5,0,0,1,1,0,5,2,24,6,33.0,17,5,3,6,1.0,58.82,0.2,0,,,0,,7,4,1,0,0,1.2,6
Vikash ,Bengal Warriors,0,0,0,0,0,5,0,0,0,5,5,0,0,6,0,0,45.0,0,4,11,5,0.0,0.0,1.25,0,,,0,,0,0,5,0,0,1.25,5
Maninder Singh,Gujarat Giants,0,0,0,0,0,0,3,0,0,0,0,0,3,1,27,3,0.0,11,3,1,3,1.0,54.55,0.0,0,,,0,,5,3,0,0,0,1.0,3
Vikrant ,Telugu Titans,0,0,0,0,0,0,3,0,2,0,0,0,1,0,20,1,0.0,5,3,0,3,1.0,40.0,0.0,0,,,0,,3,1,0,0,0,1.0,3
Gurvinder Singh,U.P. Yoddha,0,0,0,0,0,5,0,0,0,5,5,0,0,8,0,0,38.0,0,5,13,5,0.0,0.0,1.0,0,,,0,,0,0,5,0,0,1.0,5
Sachin,Gujarat Giants,1,0,29,11,5,41,781,0,108,36,36,0,673,51,40,634,41.0,1625,106,87,822,7.37,78.58,0.39,0,,,0,,348,643,41,1,10,7.75,822
Vikas Kumar,Telugu Titans,0,0,0,0,1,5,30,0,8,4,4,0,22,12,30,34,25.0,86,14,16,35,2.14,69.77,0.36,0,,,0,,26,26,5,0,0,2.5,35
Manjeet,Tamil Thalaivas,0,0,17,13,3,65,518,0,104,62,62,0,414,93,40,375,40.0,1058,86,155,583,6.02,75.61,0.76,0,,,0,,258,425,65,0,0,6.78,583
Vinod Kumar,Gujarat Giants,2,0,0,2,9,47,63,0,25,38,38,0,38,43,24,89,47.0,170,51,81,110,1.24,76.47,0.92,0,,,0,,40,41,47,0,2,2.16,110
Anil Kumar,Tamil Thalaivas,1,0,0,0,0,8,1,0,1,8,8,0,0,11,0,3,42.0,4,6,19,9,0.17,75.0,1.33,0,,,0,,1,0,8,0,0,1.5,9
Virender Singh,Patna Pirates,0,0,0,0,0,0,0,0,0,0,0,0,0,4,0,0,0.0,0,3,4,0,0.0,0.0,0.0,0,,,0,,0,0,0,0,0,0.0,0
Vijay Kumar,Tamil Thalaivas,0,0,0,0,7,28,6,0,2,21,21,0,4,59,8,20,26.0,25,37,80,34,0.16,88.0,0.76,0,,,0,,3,2,28,0,4,0.92,34
Mahender Singh,Bengaluru Bulls,15,0,0,0,26,264,3,0,3,238,238,0,0,316,2,41,43.0,46,110,554,267,0.03,91.3,2.4,0,,,0,,4,1,264,0,9,2.43,267
Suresh Kumar,Puneri Paltan,0,0,0,0,0,0,22,0,9,0,0,0,13,0,34,14,0.0,35,11,0,22,2.0,74.29,0.0,0,,,0,,9,12,0,0,0,2.0,22
More G B,Gujarat Giants,1,0,3,2,7,59,157,0,56,52,52,0,101,53,29,198,50.0,424,72,105,216,2.18,75.94,0.82,0,,,0,,102,124,59,0,0,3.0,216
Satpal ,Dabang Delhi K.C.,1,0,0,0,6,38,5,0,5,32,32,0,0,38,0,4,46.0,9,22,70,43,0.23,44.44,1.73,0,,,0,,5,0,38,0,0,1.95,43
Munish ,Telugu Titans,0,0,0,0,0,0,1,0,1,0,0,0,0,0,0,1,0.0,4,3,0,1,0.33,25.0,0.0,0,,,0,,3,0,0,0,0,0.33,1
Muruthu M,Tamil Thalaivas,0,0,0,0,0,3,0,0,0,3,3,0,0,8,0,0,27.0,1,3,11,3,0.0,0.0,1.0,0,,,0,,1,0,3,0,1,1.0,3
Pardeep Kandola,Bengaluru Bulls,0,0,0,0,0,0,0,0,0,0,0,0,0,9,0,0,0.0,0,3,9,0,0.0,0.0,0.0,0,,,0,,0,0,0,0,0,0.0,0
Narender ,U.P. Yoddha,2,0,0,0,5,42,0,0,0,37,37,0,0,90,0,0,28.999999999999996,0,29,127,42,0.0,0.0,1.45,0,,,0,,0,0,42,0,0,1.45,42
Vishnu Landge,U Mumba,0,0,0,0,0,30,0,0,0,30,30,0,0,96,0,0,24.0,0,36,126,30,0.0,0.0,0.83,0,,,0,,0,0,30,0,2,0.83,30
Parvesh ,Puneri Paltan,0,0,0,0,1,5,7,0,2,4,4,0,5,6,17,14,40.0,30,6,10,12,1.17,63.33,0.83,0,,,0,,11,5,5,0,0,2.0,12
Satish ,Patna Pirates,0,0,0,0,0,3,0,0,0,3,3,0,0,21,0,1,12.0,1,10,24,3,0.0,100.0,0.3,0,,,0,,0,0,3,0,0,0.3,3
Tushar Bhoir,Dabang Delhi K.C.,0,0,0,0,1,3,0,0,0,2,2,0,0,17,0,0,11.0,0,10,19,3,0.0,0.0,0.3,0,,,0,,0,0,3,0,0,0.3,3
Vikash Khatri,Puneri Paltan,0,0,0,0,0,0,0,0,0,0,0,0,0,1,0,0,0.0,0,1,1,0,0.0,0.0,0.0,0,,,0,,0,0,0,0,0,0.0,0
Anand V,Bengal Warriors,0,0,0,0,0,0,5,0,2,0,0,0,3,5,19,15,0.0,27,6,5,5,0.83,74.07,0.0,0,,,0,,7,5,0,0,0,0.83,5
Ruturaj Koravi,Gujarat Giants,1,0,0,0,6,82,0,0,0,76,76,0,0,140,0,9,35.0,9,50,216,82,0.0,100.0,1.64,0,,,0,,0,0,82,0,3,1.64,82
Arjun Deshwal,U Mumba,0,0,36,15,0,3,671,0,175,3,3,0,496,7,50,328,30.0,1088,68,10,674,9.87,79.96,0.04,0,,,0,,218,542,3,0,0,9.91,674
Ajinkya Kapre,U Mumba,0,0,0,2,0,7,44,0,16,7,7,0,28,11,27,42,39.0,102,25,18,51,1.76,68.63,0.28,0,,,0,,32,28,7,0,0,2.04,51
Siddharth Desai,Telugu Titans,0,0,30,22,0,9,611,0,143,9,9,0,468,16,52,207,36.0,925,63,25,620,9.7,74.16,0.14,0,,,0,,239,479,9,0,0,9.84,620
Abhishek Singh,Telugu Titans,0,0,19,9,0,12,442,0,61,12,12,0,381,39,37,403,24.0,1000,74,51,454,5.97,77.0,0.16,0,,,0,,230,367,12,0,1,6.14,454
Anil ,Bengaluru Bulls,0,0,0,0,0,0,0,0,0,0,0,0,0,0,0,0,0.0,0,0,0,0,,0.0,,0,,,0,,0,0,0,0,0,,0
Gurdeep,U.P. Yoddhas,2,0,0,0,5,56,1,0,1,51,51,0,0,88,0,0,37.0,1,44,139,57,0.02,0.0,1.27,0,,,0,,1,0,56,0,0,1.3,57
Victor Obiero,Tamil Thalaivas,0,0,0,0,1,3,15,0,6,2,2,0,9,5,44,5,28.999999999999996,25,9,7,18,1.67,64.0,0.33,0,,,0,,9,11,3,0,0,2.0,18
Md Masud Karim,U.P. Yoddha,0,0,0,0,0,0,3,0,1,0,0,0,2,0,50,0,0.0,4,3,0,3,1.0,50.0,0.0,0,,,0,,2,2,0,0,0,1.0,3
Milinda Chathuranga,Jaipur Pink Panthers,0,0,0,0,0,0,0,0,0,0,0,0,0,1,0,0,0.0,1,1,1,0,0.0,0.0,0.0,0,,,0,,1,0,0,0,0,0.0,0
Amir Dhumal,Bengal Warriors,0,0,0,0,0,0,0,0,0,0,0,0,0,0,0,0,0.0,0,0,0,0,,0.0,,0,,,0,,0,0,0,0,0,,0
Mahesh Magdum,Bengaluru Bulls,0,0,0,0,0,0,7,0,5,0,0,0,2,1,42,1,0.0,12,4,1,7,1.75,50.0,0.0,0,,,0,,6,5,0,0,0,1.75,7
Jawahar Vivek,Bengaluru Bulls,0,0,0,0,0,0,0,0,0,0,0,0,0,4,0,0,0.0,0,2,4,0,0.0,0.0,0.0,0,,,0,,0,0,0,0,0,0.0,0
C Manoj Kumar ,Telugu Titans,0,0,0,0,0,4,10,0,1,4,4,0,9,9,33,5,31.0,21,12,13,14,0.83,57.14,0.33,0,,,0,,9,7,4,0,1,1.17,14
Abhinandan Chandel,Tamil Thalaivas,0,0,0,0,0,0,0,0,0,0,0,0,0,0,0,0,0.0,0,0,0,0,,0.0,,0,,,0,,0,0,0,0,0,,0
Bhanu Tomar,U.P. Yoddha,0,0,0,0,0,0,9,0,2,0,0,0,7,2,27,5,0.0,22,6,2,9,1.5,50.0,0.0,0,,,0,,11,6,0,0,0,1.5,9
Yashwant Bishnoi,Gujarat Giants,0,0,0,0,0,0,2,0,0,0,0,0,2,2,22,3,0.0,9,3,2,2,0.67,55.56,0.0,0,,,0,,4,2,0,0,0,0.67,2
Rajnish,Telugu Titans,0,0,8,5,0,8,171,0,57,8,8,0,114,17,39,124,32.0,337,30,25,179,5.7,75.37,0.27,0,,,0,,83,130,8,1,0,5.97,179
Amit Kumar Pun,Puneri Paltan,1,0,0,1,1,27,28,0,8,26,26,0,20,29,19,49,47.0,99,21,55,55,1.33,68.69,1.29,0,,,0,,31,19,27,0,0,2.62,55
Anil ,Gujarat Giants,0,0,0,0,0,0,0,0,0,0,0,0,0,2,0,3,0.0,4,2,2,0,0.0,75.0,0.0,0,,,0,,1,0,0,0,0,0.0,0
Naveen Kumar,Dabang Delhi K.C.,0,0,58,9,2,14,934,0,237,12,12,0,697,26,51,493,32.0,1556,85,38,948,10.99,82.33,0.16,0,,,0,,275,788,14,0,0,11.15,948
Arkam Shaikh,Gujarat Giants,1,0,0,0,0,37,3,0,1,37,37,0,2,60,14,4,38.0,7,22,97,40,0.14,71.43,1.68,0,,,0,,2,1,37,0,0,1.82,40
Armaan ,Telugu Titans,0,0,1,2,1,2,22,0,6,1,1,0,16,7,27,19,12.0,55,10,8,24,2.2,61.82,0.2,0,,,0,,21,15,2,0,0,2.4,24
Mithin Kumar,Bengal Warriors,0,0,0,0,0,0,3,0,2,0,0,0,1,0,20,5,0.0,10,3,0,3,1.0,70.0,0.0,0,,,0,,3,2,0,0,0,1.0,3
Lalit Chaudhary,Gujarat Giants,0,0,0,0,2,7,6,0,2,5,5,0,4,2,15,6,71.0,20,10,7,13,0.6,45.0,0.7,0,,,0,,11,3,7,0,0,1.3,13
Kamal Singh ,Telugu Titans,0,0,0,0,1,4,13,0,7,3,3,0,6,9,16,26,25.0,43,11,12,17,1.18,76.74,0.36,0,,,0,,10,7,4,0,0,1.55,17
Gaurav Kumar,U Mumba,0,0,0,0,0,0,2,0,0,0,0,0,2,0,20,3,0.0,10,3,0,2,0.67,50.0,0.0,0,,,0,,5,2,0,0,0,0.67,2
Dharmender ,Gujarat Giants,0,0,0,1,0,0,5,0,0,0,0,0,5,0,33,0,0.0,6,4,0,5,1.25,33.33,0.0,0,,,0,,4,2,0,0,0,1.25,5
Bhuvneshwar Gaur,Gujarat Giants,0,0,0,0,0,0,8,0,3,0,0,0,5,1,42,2,0.0,12,7,1,8,1.14,58.33,0.0,0,,,0,,5,5,0,0,0,1.14,8
Azad Singh,U.P. Yoddha,0,0,0,1,0,2,27,0,11,2,2,0,16,4,23,33,33.0,74,13,6,29,2.08,67.57,0.15,0,,,0,,24,17,2,0,2,2.23,29
Arun Kumar,Haryana Steelers,0,0,0,0,0,0,3,0,2,0,0,0,1,1,20,1,0.0,10,5,1,3,0.6,30.0,0.0,0,,,0,,7,2,0,0,0,0.6,3
Mohit Balyan,U Mumba,0,0,0,0,1,2,0,0,0,1,1,0,0,2,0,0,33.0,0,2,3,2,0.0,0.0,1.0,0,,,0,,0,0,2,0,0,1.0,2
Ankit Beniwal,Telugu Titans,0,0,4,3,0,16,122,0,27,16,16,0,95,23,35,84,41.0,267,30,39,138,4.07,66.67,0.53,0,,,0,,89,94,16,0,3,4.6,138
Anand ,Tamil Thalaivas,0,0,0,1,0,0,14,0,1,0,0,0,13,3,33,11,0.0,30,8,3,14,1.75,70.0,0.0,0,,,0,,9,10,0,0,0,1.75,14
Sudhanshu Tyagi,Haryana Steelers,0,0,0,0,0,4,0,0,0,4,4,0,0,27,0,0,13.0,0,13,31,4,0.0,0.0,0.31,0,,,0,,0,0,4,0,0,0.31,4
Vimal Raj V,Tamil Thalaivas,0,0,0,0,0,0,2,0,0,0,0,0,2,6,20,4,0.0,10,5,6,2,0.4,60.0,0.0,0,,,0,,4,2,0,0,0,0.4,2
Anuj Kumar,Telugu Titans,0,0,0,0,1,5,1,0,0,4,4,0,1,7,20,4,36.0,5,7,11,6,0.14,100.0,0.71,0,,,0,,0,1,5,0,0,0.86,6
Amit Singh,Haryana Steelers,0,0,0,0,0,0,0,0,0,0,0,0,0,0,0,0,0.0,0,0,0,0,,0.0,,0,,,0,,0,0,0,0,0,,0
Anil ,U Mumba,0,0,0,0,0,0,1,0,0,0,0,0,1,3,33,2,0.0,3,2,3,1,0.5,100.0,0.0,0,,,0,,0,1,0,0,0,0.5,1
Deepak ,Telugu Titans,0,0,0,0,0,0,0,0,0,0,0,0,0,1,0,0,0.0,0,1,1,0,0.0,0.0,0.0,0,,,0,,0,0,0,0,0,0.0,0
Vikram Kandola,Gujarat Giants,0,0,0,0,0,1,0,0,0,1,1,0,0,8,0,1,11.0,1,4,9,1,0.0,100.0,0.25,0,,,0,,0,0,1,0,0,0.25,1
Naveen,Haryana Steelers,0,0,2,5,4,25,160,0,35,21,21,0,125,52,35,147,28.999999999999996,368,48,73,185,3.33,75.0,0.52,0,,,0,,92,129,25,0,5,3.85,185
Sombir,Telugu Titans,9,0,0,0,16,142,4,0,3,126,126,0,1,165,25,1,43.0,4,72,291,146,0.06,50.0,1.97,0,,,0,,2,1,142,0,1,2.03,146
Amit,Gujarat Giants,0,0,0,0,2,13,0,0,0,11,11,0,0,42,0,1,21.0,1,24,53,13,0.0,100.0,0.54,0,,,0,,0,0,13,0,1,0.54,13
Akash Chaudhary,Telugu Titans,1,0,0,0,2,38,0,0,0,36,36,0,0,72,0,3,33.0,3,23,108,38,0.0,100.0,1.65,0,,,0,,0,0,38,1,0,1.65,38
Balasaheb Jadhav,Puneri Paltan,3,0,0,0,7,41,0,0,0,34,34,0,0,61,0,0,36.0,1,32,95,41,0.0,0.0,1.28,0,,,0,,1,0,41,0,0,1.28,41
M. Abishek,Tamil Thalaivas,1,0,0,0,1,65,0,0,0,64,64,0,0,138,0,0,32.0,0,39,202,65,0.0,0.0,1.67,0,,,0,,0,0,65,0,0,1.67,65
Mohit Sehrawat,Bengaluru Bulls,1,0,0,0,2,22,5,0,1,20,20,0,4,49,7,39,28.999999999999996,57,28,69,27,0.18,75.44,0.79,0,,,0,,14,4,22,0,0,0.96,27
Pavan TR,Jaipur Pink Panthers,0,0,0,0,4,17,0,0,0,13,13,0,0,43,0,0,23.0,0,26,56,17,0.0,0.0,0.65,0,,,0,,0,0,17,0,0,0.65,17
Rohit Gulia,Gujarat Giants,0,0,12,9,1,18,440,0,133,17,17,0,307,76,33,429,18.0,1033,94,93,458,4.68,75.02,0.19,0,,,0,,258,346,18,0,3,4.87,458
Sahil,Tamil Thalaivas,0,0,0,0,0,6,0,0,0,6,6,0,0,19,0,0,24.0,0,11,25,6,0.0,0.0,0.55,0,,,0,,0,0,6,0,0,0.55,6
Ankush,U.P. Yoddhas,0,0,0,0,0,1,10,0,3,1,1,0,7,1,24,11,50.0,29,12,2,11,0.83,62.07,0.08,0,,,0,,11,7,1,0,0,0.92,11
Ashish,Haryana Steelers,0,0,4,5,2,39,165,0,47,37,37,0,118,32,33,161,54.0,377,43,69,204,3.84,75.86,0.91,0,,,0,,91,125,39,0,0,4.74,204
Banty,Bengaluru Bulls,0,0,0,0,0,3,22,0,4,3,3,0,18,9,23,33,25.0,70,15,12,25,1.47,70.0,0.2,0,,,0,,21,16,3,0,0,1.67,25
Guman Singh,Patna Pirates,0,0,11,8,0,2,237,0,52,2,2,0,185,16,37,208,11.0,489,40,18,239,5.92,79.96,0.05,0,,,0,,98,183,2,0,0,5.98,239
Mohit,Patna Pirates,0,0,0,0,0,0,3,0,0,0,0,0,3,0,21,7,0.0,14,1,0,3,3.0,71.43,0.0,0,,,0,,4,3,0,0,0,3.0,3
Neeraj Narwal,Dabang Delhi K.C.,0,0,3,6,3,26,148,0,52,23,23,0,96,41,31,133,36.0,315,47,64,174,3.15,73.02,0.55,0,,,0,,85,97,26,0,0,3.7,174
Nitin Panwar,U.P. Yoddhas,0,0,0,0,0,2,2,0,1,2,2,0,1,5,33,1,28.999999999999996,3,5,7,4,0.4,66.67,0.4,0,,,0,,1,1,2,0,0,0.8,4
Rakesh Gowda,Telugu Titans,0,0,1,1,3,15,88,0,45,12,12,0,43,24,35,81,33.0,197,26,36,103,3.38,76.14,0.58,0,,,0,,47,69,15,0,0,3.96,103
Sushil Gulia,Jaipur Pink Panthers,0,0,0,2,0,1,19,0,2,1,1,0,17,2,24,21,33.0,49,7,3,20,2.71,67.35,0.14,0,,,0,,16,12,1,0,0,2.86,20
V Ajith Kumar,Tamil Thalaivas,0,0,14,8,0,3,380,0,64,3,3,0,316,24,43,234,11.0,724,60,27,383,6.33,75.41,0.05,0,,,0,,178,312,3,0,0,6.38,383
Vinay,Haryana Steelers,0,0,3,8,0,5,209,0,56,5,5,0,153,21,41,137,19.0,379,53,26,214,3.94,77.31,0.09,0,,,0,,86,156,5,0,1,4.04,214
Nitin Rawal,Haryana Steelers,3,0,2,7,10,94,142,0,41,84,84,0,101,129,26,198,39.0,379,81,213,236,1.75,78.36,1.16,0,,,0,,82,99,94,0,7,2.91,236
Brijendra Singh Chaudhary,Jaipur Pink Panthers,0,0,0,1,0,8,20,0,10,8,8,0,10,9,41,9,47.0,29,7,17,28,2.86,72.41,1.14,0,,,0,,8,12,8,0,0,4.0,28
Purna Singh,Gujarat Giants,0,0,0,0,0,0,6,0,3,0,0,0,3,3,22,12,0.0,23,10,3,6,0.6,73.91,0.0,0,,,0,,6,5,0,0,0,0.6,6
Santhapanaselvam,Tamil Thalaivas,0,0,0,0,3,43,0,0,0,40,40,0,0,71,0,1,36.0,1,37,111,43,0.0,100.0,1.16,0,,,0,,0,0,43,0,1,1.16,43
Vijay Malik,Patna Pirates,1,0,10,10,6,77,366,0,157,71,71,0,209,142,39,302,33.0,706,96,213,443,3.81,82.15,0.8,0,,,0,,126,278,77,0,1,4.61,443
Monu,Puneri Paltan,1,0,0,3,13,101,102,0,20,88,88,0,82,110,21,231,44.0,393,87,198,203,1.17,79.9,1.16,0,,,0,,79,83,101,0,2,2.33,203
Vishal Bhardwaj,Telugu Titans,19,0,0,0,31,288,5,0,4,257,257,0,1,294,1,71,47.0,77,99,551,293,0.05,93.51,2.91,0,,,0,,5,1,288,1,27,2.96,293
Rinku Narwal,Gujarat Giants,6,0,0,0,11,148,3,0,2,137,137,0,1,195,8,19,41.0,24,75,332,151,0.04,87.5,1.97,0,,,0,,3,2,148,0,2,2.01,151
Surinder Singh,Telugu Titans,8,0,0,1,11,240,6,0,2,229,229,0,4,355,3,30,39.0,36,101,584,246,0.06,86.11,2.38,0,,,0,,5,1,240,1,6,2.44,246
Subash E,U Mumba,0,0,0,0,1,4,0,0,0,3,3,0,0,7,0,0,30.0,0,4,10,4,0.0,0.0,1.0,0,,,0,,0,0,4,0,0,1.0,4
Nitesh Kumar,U.P. Yoddhas,20,0,0,0,23,313,3,0,3,290,290,0,0,281,0,7,51.0,11,113,571,316,0.03,63.64,2.77,0,,,0,,4,0,313,0,14,2.8,316
Pankaj,Gujarat Giants,2,0,0,0,0,44,0,0,0,44,44,0,0,64,0,4,41.0,8,28,108,44,0.0,50.0,1.57,0,,,0,,4,0,44,0,1,1.57,44
Aashish Nagar,U.P. Yoddhas,0,0,0,0,0,1,0,0,0,1,1,0,0,6,0,0,14.000000000000002,0,5,7,1,0.0,0.0,0.2,0,,,0,,0,0,1,0,0,0.2,1
Ravindra Kumavat,Bengal Warriors,0,0,0,2,0,8,56,0,11,8,8,0,45,22,29,72,27.0,156,25,30,64,2.24,75.64,0.32,0,,,0,,38,46,8,0,0,2.56,64
Adarsh T,Telugu Titans,0,0,1,3,6,32,112,0,17,26,26,0,95,45,34,93,37.0,247,58,71,144,1.93,71.66,0.55,0,,,0,,70,84,32,0,0,2.48,144
Ajinkya Pawar,Tamil Thalaivas,0,0,8,5,4,21,330,0,78,17,17,0,252,36,34,328,32.0,744,71,53,351,4.65,77.82,0.3,0,,,0,,165,251,21,0,0,4.94,351
Aman Kadian,Dabang Delhi K.C.,0,0,0,0,0,1,6,0,4,1,1,0,2,3,21,4,25.0,14,5,4,7,1.2,50.0,0.2,0,,,0,,7,3,1,0,0,1.4,7
Ankit,Tamil Thalaivas,0,0,0,0,1,20,1,0,1,19,19,0,0,49,0,14,28.000000000000004,16,24,68,21,0.04,87.5,0.83,0,,,0,,2,0,20,0,2,0.88,21
Parveen Satpal,Haryana Steelers,1,0,0,0,6,37,3,0,2,31,31,0,1,78,13,6,28.000000000000004,8,40,109,40,0.08,87.5,0.92,0,,,0,,1,1,37,0,2,1.0,40
Ponparthiban Subramanian,Tamil Thalaivas,2,0,0,0,1,33,0,0,0,32,32,0,0,62,0,0,34.0,0,25,94,33,0.0,0.0,1.32,0,,,0,,0,0,33,0,1,1.32,33
Shubham Shinde,Puneri Paltan,2,0,0,0,11,89,3,0,1,78,78,0,2,126,6,27,38.0,33,62,204,92,0.05,87.88,1.44,0,,,0,,4,2,89,0,3,1.48,92
Sumit Singh,Bengaluru Bulls,0,0,0,0,2,12,78,0,39,10,10,0,39,20,30,81,33.0,194,37,30,90,2.11,71.65,0.32,0,,,0,,55,58,12,0,2,2.43,90
Sunil,Haryana Steelers,10,0,0,0,4,186,1,0,1,182,182,0,0,266,0,3,41.0,5,87,448,187,0.01,60.0,2.14,0,,,0,,2,0,186,1,7,2.15,187
Neeraj Kumar,Patna Pirates,7,0,0,0,8,141,2,0,2,133,133,0,0,209,0,22,39.0,25,66,342,143,0.03,88.0,2.14,0,,,0,,3,0,141,0,3,2.17,143
Ajeet,Tamil Thalaivas,0,0,0,0,1,17,0,0,0,16,16,0,0,44,0,1,27.0,1,16,60,17,0.0,100.0,1.06,0,,,0,,0,0,17,0,1,1.06,17
Amit Sheoran,Bengal Warriors,5,0,0,0,8,97,1,0,1,89,89,0,0,110,0,0,45.0,2,54,199,98,0.02,0.0,1.8,0,,,0,,2,0,97,0,2,1.81,98
Amit Nirwal,U.P. Yoddha,2,0,0,0,5,67,2,0,0,62,62,0,2,126,7,14,33.0,15,53,188,69,0.04,100.0,1.26,0,,,0,,0,1,67,0,2,1.3,69
Sonu,Gujarat Giants,0,0,3,5,1,9,113,0,12,8,8,0,101,12,39,78,40.0,217,29,20,122,3.9,75.12,0.31,0,,,0,,54,85,9,0,0,4.21,122
Harendra Kumar,U Mumba,1,0,0,0,5,76,1,0,1,71,71,0,0,160,0,5,31.0,7,62,231,77,0.02,71.43,1.23,0,,,0,,2,0,76,0,0,1.24,77
Tapas Pal,Bengal Warriors,0,0,0,0,0,11,0,0,0,11,11,0,0,16,0,0,41.0,0,9,27,11,0.0,0.0,1.22,0,,,0,,0,0,11,0,1,1.22,11
Manoj Gowda,Bengal Warriors,0,0,0,2,1,8,44,0,16,7,7,0,28,21,31,43,25.0,93,21,28,52,2.1,77.42,0.38,0,,,0,,21,29,8,0,0,2.48,52
Nitin Panwar,Jaipur Pink Panthers,0,0,0,0,0,0,6,0,2,0,0,0,4,0,36,3,0.0,14,5,0,6,1.2,57.14,0.0,0,,,0,,6,5,0,0,0,1.2,6
Sachin Narwal,Jaipur Pink Panthers,0,0,0,1,0,2,61,0,28,2,2,0,33,14,35,49,12.0,130,36,16,63,1.69,72.31,0.06,0,,,0,,36,45,2,0,0,1.75,63
Sourabh Patil,Bengal Warriors,0,0,1,0,0,0,17,0,2,0,0,0,15,3,58,4,0.0,26,3,3,17,5.67,73.08,0.0,0,,,0,,7,15,0,0,0,5.67,17
Vishal,Jaipur Pink Panthers,7,0,0,0,14,162,3,0,1,148,148,0,2,254,9,18,37.0,23,70,402,165,0.04,86.96,2.31,0,,,0,,3,2,162,0,5,2.36,165
Himanshu,Tamil Thalaivas,0,0,0,2,4,32,74,0,19,28,28,0,55,50,25,125,36.0,229,38,78,106,1.95,79.91,0.84,0,,,0,,46,58,32,0,0,2.79,106
Karamvir,Puneri Paltan,0,0,0,0,0,6,1,0,1,6,6,0,0,14,0,0,30.0,1,12,20,7,0.08,0.0,0.5,0,,,0,,1,0,6,0,1,0.58,7
Manish,Telugu Titans,0,0,0,0,0,2,0,0,0,2,2,0,0,12,0,0,14.000000000000002,0,4,14,2,0.0,0.0,0.5,0,,,0,,0,0,2,0,0,0.5,2
Satywan,U Mumba,0,0,0,0,0,2,0,0,0,2,2,0,0,5,0,0,28.999999999999996,0,4,7,2,0.0,0.0,0.5,0,,,0,,0,0,2,0,0,0.5,2
Daniel Odhiambo,Patna Pirates,0,0,0,0,0,0,11,0,2,0,0,0,9,3,48,5,0.0,23,3,3,11,3.67,69.57,0.0,0,,,0,,7,11,0,0,0,3.67,11
Mohammad Mahalli,Haryana Steelers,0,0,0,0,4,16,41,0,16,12,12,0,25,25,24,71,32.0,135,28,37,57,1.46,76.3,0.57,0,,,0,,32,32,16,0,0,2.04,57
Mohammad Nabibakhsh,Puneri Paltan,1,0,2,6,6,63,203,0,43,57,57,0,160,83,32,234,41.0,493,58,140,266,3.5,79.11,1.09,0,,,0,,103,156,63,0,0,4.59,266
Mohammad Taghi Paein Mahali,U.P. Yoddhas,0,0,0,1,0,4,16,0,6,4,4,0,10,11,31,8,27.0,29,11,15,20,1.45,58.62,0.36,0,,,0,,12,9,4,0,0,1.82,20
Emad Sedaghatnia,Puneri Paltan,0,0,0,1,0,0,14,0,4,0,0,0,10,5,47,1,0.0,17,3,5,14,4.67,52.94,0.0,0,,,0,,8,8,0,0,0,4.67,14
Amirhossein Mohammad Maleki,Jaipur Pink Panthers,0,0,0,0,0,0,5,0,1,0,0,0,4,1,80,0,0.0,5,2,1,5,2.5,80.0,0.0,0,,,0,,1,4,0,0,0,2.5,5
Nehal Desai,U.P. Yoddhas,0,0,0,0,0,0,0,0,0,0,0,0,0,0,0,0,0.0,1,1,0,0,0.0,0.0,0.0,0,,,0,,1,0,0,0,0,0.0,0
Ravinder,Patna Pirates,0,0,0,0,1,3,0,0,0,2,2,0,0,6,0,0,25.0,0,5,8,3,0.0,0.0,0.6,0,,,0,,0,0,3,0,0,0.6,3
Chand Singh,Haryana Steelers,0,0,0,0,2,8,1,0,0,6,6,0,1,21,100,0,22.0,1,12,27,9,0.08,100.0,0.67,0,,,0,,0,1,8,0,0,0.75,9
Balram,Dabang Delhi K.C.,0,0,0,0,0,1,3,0,1,1,1,0,2,2,14,4,33.0,7,5,3,4,0.6,71.43,0.2,0,,,0,,2,1,1,0,0,0.8,4
Mohit Bhainswal,Dabang Delhi K.C.,0,0,0,0,0,0,0,0,0,0,0,0,0,5,0,0,0.0,0,1,5,0,0.0,0.0,0.0,0,,,0,,0,0,0,0,0,0.0,0
Sumit Bhainswal,Dabang Delhi K.C.,0,0,0,0,0,2,0,0,0,2,2,0,0,7,0,0,22.0,0,3,9,2,0.0,0.0,0.67,0,,,0,,0,0,2,0,0,0.67,2
Harmanjit Singh,Gujarat Giants,0,0,0,0,0,0,8,0,3,0,0,0,5,1,21,10,0.0,24,8,1,8,1.0,62.5,0.0,0,,,0,,9,5,0,0,0,1.0,8
Sumit,Gujarat Giants,0,0,0,0,1,19,0,0,0,18,18,0,0,33,0,0,35.0,0,20,51,19,0.0,0.0,0.95,0,,,0,,0,0,19,0,1,0.95,19
Ankit,Gujarat Giants,1,0,0,0,11,48,2,0,1,37,37,0,1,75,67,1,33.0,3,38,112,50,0.05,100.0,1.26,0,,,0,,0,2,48,0,3,1.32,50
Saurabh Nandal,Bengaluru Bulls,10,0,0,0,16,197,2,0,0,181,181,0,2,187,40,2,49.0,5,71,368,199,0.03,80.0,2.77,0,,,0,,1,2,197,0,2,2.8,199
Vikas Chhillar,Haryana Steelers,0,0,0,0,0,0,3,0,0,0,0,0,3,0,50,0,0.0,6,2,0,3,1.5,50.0,0.0,0,,,0,,3,3,0,0,0,1.5,3
Elavarasan,Jaipur Pink Panthers,0,0,0,0,1,4,0,0,0,3,3,0,0,7,0,0,30.0,0,4,10,4,0.0,0.0,1.0,0,,,0,,0,0,4,0,0,1.0,4
Pankaj Mohite,Puneri Paltan,0,0,5,4,1,12,184,0,34,11,11,0,150,32,38,149,26.0,381,36,43,196,5.11,77.17,0.33,0,,,0,,87,145,12,0,0,5.44,196
Sanket Sawant,Puneri Paltan,0,0,0,0,2,63,0,0,0,61,61,0,0,141,0,1,30.0,2,52,202,63,0.0,50.0,1.21,0,,,0,,1,0,63,1,2,1.21,63
Sushant Sail,Puneri Paltan,0,0,0,1,1,4,24,0,6,3,3,0,18,8,28,17,27.0,54,14,11,28,1.71,59.26,0.29,0,,,0,,22,15,4,0,0,2.0,28
Sagar,Tamil Thalaivas,14,0,0,0,19,157,1,0,1,138,138,0,0,134,0,0,51.0,2,52,272,158,0.02,0.0,3.02,0,,,0,,2,0,157,0,3,3.04,158
Aakash Arsul,Telugu Titans,1,0,0,0,0,8,0,0,0,8,8,0,0,19,0,0,30.0,0,7,27,8,0.0,0.0,1.14,0,,,0,,0,0,8,0,0,1.14,8
Navneet,U Mumba,0,0,0,0,0,0,8,0,1,0,0,0,7,1,33,4,0.0,18,4,1,8,2.0,55.56,0.0,0,,,0,,8,6,0,0,0,2.0,8
Ashu Singh,U.P. Yoddhas,4,0,0,0,15,140,4,0,2,125,125,0,2,192,5,37,39.0,40,69,317,144,0.06,97.5,2.03,0,,,0,,1,2,140,0,6,2.09,144
Sumit,U.P. Yoddhas,14,0,0,0,10,193,6,0,3,183,183,0,3,221,18,11,45.0,17,67,404,199,0.09,82.35,2.88,0,,,0,,3,3,193,0,2,2.97,199
Surender Gill,U.P. Yoddhas,0,0,16,15,4,23,400,0,91,19,19,0,309,35,39,315,35.0,768,55,54,423,7.27,80.08,0.42,0,,,0,,153,300,23,0,1,7.69,423
Sajin C,Patna Pirates,1,0,0,0,6,45,0,0,0,39,39,0,0,82,0,1,32.0,1,36,121,45,0.0,100.0,1.25,0,,,0,,0,0,45,4,8,1.25,45
Rathan K,Gujarat Giants,0,0,0,1,1,4,9,0,3,3,3,0,6,5,19,13,38.0,27,9,8,13,1.0,66.67,0.44,0,,,0,,9,5,4,0,0,1.44,13
Ankush,Jaipur Pink Panthers,9,0,0,0,5,89,0,0,0,84,84,0,0,48,0,0,64.0,0,24,132,89,0.0,0.0,3.71,0,,,0,,0,0,89,0,0,3.71,89
Sourav Gulia,Gujarat Giants,3,0,0,0,0,40,0,0,0,40,40,0,0,54,0,0,43.0,0,19,94,40,0.0,0.0,2.11,0,,,0,,0,0,40,0,0,2.11,40
Rinku,U Mumba,7,0,0,0,14,119,0,0,0,105,105,0,0,101,0,17,51.0,18,41,206,119,0.0,94.44,2.9,0,,,0,,1,0,119,0,2,2.9,119
Manjeet,Dabang Delhi K.C.,0,0,1,3,2,10,70,0,21,8,8,0,49,18,39,31,31.0,125,25,26,80,2.8,64.0,0.4,0,,,0,,45,49,10,0,0,3.2,80
Rakesh,Gujarat Giants,0,0,12,7,0,2,271,0,66,2,2,0,205,22,38,227,8.0,568,39,24,273,6.95,77.82,0.05,0,,,0,,126,215,2,0,0,7.0,273
Prince D,Telugu Titans,0,0,0,0,3,15,3,0,1,12,12,0,2,52,12,11,19.0,17,23,64,18,0.13,76.47,0.65,0,,,0,,4,2,15,0,0,0.78,18
Himanshu Narwal,Tamil Thalaivas,0,0,0,0,0,0,6,0,4,0,0,0,2,0,30,3,0.0,10,3,0,6,2.0,60.0,0.0,0,,,0,,4,3,0,0,0,2.0,6
Durgesh Kumar,U.P. Yoddhas,0,0,0,1,0,3,16,0,4,3,3,0,12,4,24,9,43.0,29,10,7,19,1.6,55.17,0.3,0,,,0,,13,7,3,0,0,1.9,19
Monu,Dabang Delhi K.C.,0,0,0,0,0,0,0,0,0,0,0,0,0,0,0,0,0.0,0,0,0,0,0.0,0.0,0.0,0,,,0,,0,0,0,0,0,0.0,0
Mohit Goyat,Puneri Paltan,1,0,12,6,4,45,279,0,27,41,41,0,252,40,41,228,51.0,562,38,81,324,7.34,81.85,1.18,0,,,0,,102,232,45,0,0,8.53,324
Shivansh Thakur,U Mumba,1,0,0,0,2,9,0,0,0,7,7,0,0,11,0,6,39.0,6,6,18,9,0.0,100.0,1.5,0,,,0,,0,0,9,0,0,1.5,9
Nitin Chandel,Jaipur Pink Panthers,0,0,0,0,0,1,0,0,0,1,1,0,0,6,0,0,14.000000000000002,0,3,7,1,0.0,0.0,0.33,0,,,0,,0,0,1,0,0,0.33,1
Sager Kumar,Patna Pirates,1,0,0,0,0,7,0,0,0,7,7,0,0,1,0,0,88.0,0,1,8,7,0.0,0.0,7.0,0,,,0,,0,0,7,0,0,7.0,7
Tejas Patil,Dabang Delhi K.C.,0,0,0,0,0,0,1,0,0,0,0,0,1,0,25,2,0.0,4,2,0,1,0.5,75.0,0.0,0,,,0,,1,1,0,0,0,0.5,1
D MahindraPrasad,Puneri Paltan,0,0,0,0,0,0,1,0,0,0,0,0,1,2,17,2,0.0,6,1,2,1,1.0,50.0,0.0,0,,,0,,3,1,0,0,0,1.0,1
Lovepreet Singh,Haryana Steelers,0,0,0,0,0,2,7,0,0,2,2,0,7,2,40,1,50.0,15,3,4,9,2.33,46.67,0.67,0,,,0,,8,6,2,0,0,3.0,9
Sushil,Haryana Steelers,0,0,1,0,0,0,17,0,4,0,0,0,13,3,56,6,0.0,27,5,3,17,3.4,77.78,0.0,0,,,0,,6,15,0,0,0,3.4,17
Meetu Sharma,Haryana Steelers,0,0,8,4,1,2,210,0,45,1,1,0,165,4,34,212,20.0,510,36,5,212,5.83,75.29,0.06,0,,,0,,126,172,2,0,0,5.89,212
Jaideep Dahiya,Haryana Steelers,9,0,0,0,10,120,3,0,2,110,110,0,1,121,6,13,48.0,18,43,231,123,0.07,77.78,2.79,0,,,0,,4,1,120,0,7,2.86,123
Rahul Sethpal,U Mumba,2,0,0,0,8,50,12,0,8,42,42,0,4,68,13,33,38.0,46,33,110,62,0.36,84.78,1.52,0,,,0,,7,6,50,0,1,1.88,62
Abinesh Nadarajan,Puneri Paltan,4,0,0,0,8,78,5,0,2,70,70,0,3,113,18,7,38.0,11,37,183,83,0.14,81.82,2.11,0,,,0,,2,2,78,0,4,2.24,83
Sakthivel R,Bengal Warriors,0,0,0,0,0,5,0,0,0,5,5,0,0,11,0,0,31.0,0,7,16,5,0.0,0.0,0.71,0,,,0,,0,0,5,0,0,0.71,5
K. Abhimanyu,Tamil Thalaivas,0,0,0,0,0,1,2,0,0,1,1,0,2,6,33,2,14.000000000000002,3,6,7,3,0.33,100.0,0.17,0,,,0,,0,1,1,0,0,0.5,3
Rohit Tomar,U.P. Yoddhas,1,0,1,1,3,18,85,0,36,15,15,0,49,31,34,97,33.0,206,23,46,103,3.7,81.07,0.78,0,,,0,,39,70,18,0,0,4.48,103
Arpit Saroha,Tamil Thalaivas,1,0,0,0,3,14,0,0,0,11,11,0,0,14,0,0,44.0,0,8,25,14,0.0,0.0,1.75,0,,,0,,0,0,14,0,0,1.75,14
Shubham Kumar,U.P. Yoddhas,0,0,0,0,4,37,1,0,1,33,33,0,0,82,0,0,28.999999999999996,1,32,115,38,0.03,0.0,1.16,0,,,0,,1,0,37,0,2,1.19,38
Akash Pikalmunde,Bengal Warriors,0,0,1,0,0,2,28,0,10,2,2,0,18,3,32,20,40.0,53,10,5,30,2.8,69.81,0.2,0,,,0,,16,17,2,0,0,3.0,30
Manuj,Gujarat Giants,0,0,0,0,0,11,0,0,0,11,11,0,0,23,0,0,32.0,0,11,34,11,0.0,0.0,1.0,0,,,0,,0,0,11,0,0,1.0,11
Rohit,Bengal Warriors,0,0,0,1,1,6,28,0,10,5,5,0,18,11,38,18,31.0,45,15,16,34,1.87,77.78,0.4,0,,,0,,10,17,6,0,1,2.27,34
Kapil,Gujarat Giants,0,0,0,0,0,9,0,0,0,9,9,0,0,16,0,0,36.0,0,7,25,9,0.0,0.0,1.29,0,,,0,,0,0,9,0,0,1.29,9
Vishwas S,Puneri Paltan,0,0,0,0,0,1,19,0,8,1,1,0,11,2,30,17,33.0,47,8,3,20,2.38,65.96,0.12,0,,,0,,16,14,1,0,0,2.5,20
Sahul Kumar,Jaipur Pink Panthers,4,0,0,0,5,101,1,0,0,96,96,0,1,130,10,9,42.0,10,42,226,102,0.02,100.0,2.4,0,,,0,,0,1,101,0,3,2.43,102
K Hanumanthu,Telugu Titans,0,0,1,0,0,4,24,0,1,4,4,0,23,5,37,13,44.0,57,8,9,28,3.0,59.65,0.5,0,,,0,,23,21,4,0,0,3.5,28
Abdul Insamam,Patna Pirates,0,0,0,0,0,0,10,0,7,0,0,0,3,4,28,5,0.0,18,7,4,10,1.43,55.56,0.0,0,,,0,,8,5,0,0,0,1.43,10
Mayur Kadam,Bengaluru Bulls,0,0,0,0,1,30,0,0,0,29,29,0,0,73,0,0,28.000000000000004,0,36,102,30,0.0,0.0,0.83,0,,,0,,0,0,30,0,1,0.83,30
Sudhakar Krishant,Bengaluru Bulls,0,0,0,0,1,7,0,0,0,6,6,0,0,9,0,0,40.0,0,9,15,7,0.0,0.0,0.78,0,,,0,,0,0,7,0,0,0.78,7
Govind Gurjar,Puneri Paltan,0,0,0,0,0,5,1,0,0,5,5,0,1,2,33,1,71.0,3,2,7,6,0.5,66.67,2.5,0,,,0,,1,1,5,0,0,3.0,6
Hamid Nader,Haryana Steelers,0,0,0,0,0,0,0,0,0,0,0,0,0,6,0,0,0.0,0,3,6,0,0.0,0.0,0.0,0,,,0,,0,0,0,0,0,0.0,0
Mohammadreza Chiyaneh,Patna Pirates,16,0,0,0,13,173,10,0,5,160,160,0,5,126,22,28,56.00000000000001,41,44,286,183,0.23,90.24,3.93,0,,,0,,4,9,173,0,5,4.16,183
Amirhossein Bastami,Haryana Steelers,1,0,0,0,1,23,1,0,1,22,22,0,0,47,0,0,32.0,1,16,69,24,0.06,0.0,1.44,0,,,0,,1,0,23,0,0,1.5,24
Soleiman Pahlevani,Gujarat Giants,0,0,0,0,1,3,0,0,0,2,2,0,0,10,0,0,17.0,0,7,12,3,0.0,0.0,0.43,0,,,0,,0,0,3,0,1,0.43,3
James Kamweti,U.P. Yoddhas,0,0,0,0,0,1,6,0,2,1,1,0,4,0,30,2,100.0,10,5,1,7,1.2,50.0,0.2,0,,,0,,5,3,1,0,0,1.4,7
Aslam Thambi,Bengal Warriors,0,0,0,1,0,0,9,0,4,0,0,0,5,0,22,4,0.0,18,5,0,9,1.8,44.44,0.0,0,,,0,,10,4,0,0,0,1.8,9
Nageshor Tharu,Bengaluru Bulls,0,0,0,0,0,0,0,0,0,0,0,0,0,0,0,0,0.0,0,0,0,0,0.0,0.0,0.0,0,,,0,,0,0,0,0,0,0.0,0
Pardeep Kumar,Gujarat Giants,0,0,1,3,0,4,76,0,10,4,4,0,66,21,35,56,16.0,153,22,25,80,3.45,71.9,0.18,0,,,0,,43,54,4,0,0,3.64,80
Bharat,Bengaluru Bulls,0,0,19,14,0,17,394,0,69,17,17,0,325,41,54,109,28.999999999999996,591,46,58,411,8.57,72.08,0.37,0,,,0,,165,317,17,0,0,8.93,411
Rohit Kumar,Bengaluru Bulls,0,0,0,0,0,1,0,0,0,1,1,0,0,3,0,0,25.0,0,2,4,1,0.0,0.0,0.5,0,,,0,,0,0,1,0,1,0.5,1
Ashu Malik,Dabang Delhi K.C.,1,0,5,6,6,25,192,0,47,19,19,0,145,38,33,173,33.0,415,45,57,217,4.27,75.18,0.56,0,,,0,,103,139,25,0,0,4.82,217
Dipak,Dabang Delhi K.C.,1,0,0,0,2,13,0,0,0,11,11,0,0,25,0,0,31.0,0,13,36,13,0.0,0.0,1.0,0,,,0,,0,0,13,0,0,1.0,13
Krishan,Dabang Delhi K.C.,2,0,0,0,5,61,0,0,0,56,56,0,0,112,0,0,33.0,0,42,168,61,0.0,0.0,1.45,0,,,0,,0,0,61,0,0,1.45,61
Vinay Kumar,Dabang Delhi K.C.,0,0,0,0,0,0,0,0,0,0,0,0,0,1,0,0,0.0,0,1,1,0,0.0,0.0,0.0,0,,,0,,0,0,0,0,0,0.0,0
Sonu Singh,Gujarat Giants,0,0,0,0,0,0,0,0,0,0,0,0,0,0,0,2,0.0,4,2,0,0,0.0,50.0,0.0,0,,,0,,2,0,0,0,0,0.0,0
Mohit Nandal,Haryana Steelers,3,0,0,0,7,86,1,0,1,79,79,0,0,95,0,0,45.0,2,43,174,87,0.02,0.0,2.0,0,,,0,,2,0,86,0,3,2.02,87
Deepak Singh,Jaipur Pink Panthers,0,0,0,0,1,18,0,0,0,17,17,0,0,60,0,1,22.0,1,17,77,18,0.0,100.0,1.06,0,,,0,,0,0,18,0,1,1.06,18
Manish,Patna Pirates,0,0,0,0,1,7,1,0,1,6,6,0,0,35,0,0,15.0,1,14,41,8,0.07,0.0,0.5,0,,,0,,1,0,7,0,0,0.57,8
Rohit,Patna Pirates,0,0,0,0,0,0,1,0,0,0,0,0,1,0,20,2,0.0,5,1,0,1,1.0,60.0,0.0,0,,,0,,2,1,0,0,0,1.0,1
Akash Shinde,Puneri Paltan,0,0,5,5,0,3,148,0,37,3,3,0,111,5,49,62,38.0,233,25,8,151,5.92,75.54,0.12,0,,,0,,57,114,3,0,0,6.04,151
Aslam Inamdar,Puneri Paltan,0,0,9,7,1,32,307,0,97,31,31,0,210,54,41,267,36.0,623,40,85,339,7.68,83.47,0.8,0,,,0,,103,253,32,0,0,8.48,339
Shubham Shelke,Puneri Paltan,0,0,0,0,0,0,3,0,1,0,0,0,2,1,13,6,0.0,15,6,1,3,0.5,53.33,0.0,0,,,0,,7,2,0,0,0,0.5,3
Aashish,Tamil Thalaivas,0,0,0,0,2,11,1,0,0,9,9,0,1,21,50,1,30.0,2,9,30,12,0.11,100.0,1.22,0,,,0,,0,1,11,0,0,1.33,12
Himanshu Singh,Tamil Thalaivas,0,0,1,3,1,6,52,0,20,5,5,0,32,16,26,53,24.0,118,24,21,58,2.17,71.19,0.25,0,,,0,,34,31,6,0,0,2.42,58
Mohit,Tamil Thalaivas,1,0,0,0,1,56,2,0,0,55,55,0,2,111,10,13,33.0,20,42,166,58,0.05,75.0,1.33,0,,,0,,5,2,56,0,1,1.38,58
Sahil Gulia,Tamil Thalaivas,2,0,0,0,4,87,0,0,0,83,83,0,0,117,0,0,42.0,0,41,200,87,0.0,0.0,2.12,0,,,0,,0,0,87,0,0,2.12,87
Muhammed Shihas,Telugu Titans,2,0,0,0,3,15,3,0,2,12,12,0,1,44,8,8,21.0,13,14,56,18,0.21,69.23,1.07,0,,,0,,4,1,15,0,1,1.29,18
Palla Ramakrishna,Telugu Titans,0,0,0,0,0,2,1,0,1,2,2,0,0,6,0,0,25.0,1,3,8,3,0.33,0.0,0.67,0,,,0,,1,0,2,0,1,1.0,3
Kamlesh,U Mumba,0,0,0,0,0,0,10,0,6,0,0,0,4,0,23,2,0.0,13,6,0,10,1.67,38.46,0.0,0,,,0,,8,3,0,0,0,1.67,10
Prince,U Mumba,0,0,0,0,0,1,0,0,0,1,1,0,0,2,0,0,33.0,0,3,3,1,0.0,0.0,0.33,0,,,0,,0,0,1,0,0,0.33,1
Shivam,U Mumba,0,0,0,0,2,6,41,0,12,4,4,0,29,11,39,27,27.0,83,20,15,47,2.05,71.08,0.3,0,,,0,,24,32,6,0,0,2.35,47
Aman,U.P. Yoddhas,0,0,0,0,0,1,4,0,0,1,1,0,4,1,25,8,50.0,16,4,2,5,1.0,75.0,0.25,0,,,0,,4,4,1,0,0,1.25,5
Aman,Bengaluru Bulls,4,0,0,0,5,113,1,0,1,108,108,0,0,134,0,2,45.0,3,47,242,114,0.02,66.67,2.4,0,,,0,,1,0,113,0,2,2.43,114
Sawin,Gujarat Giants,0,0,0,0,0,0,0,0,0,0,0,0,0,0,0,0,0.0,0,0,0,0,0.0,0.0,0.0,0,,,0,,0,0,0,0,0,0.0,0
Ankit,Haryana Steelers,0,0,0,0,0,4,0,0,0,4,4,0,0,16,0,0,20.0,0,6,20,4,0.0,0.0,0.67,0,,,0,,0,0,4,0,0,0.67,4
Balaji D,Patna Pirates,0,0,0,0,1,26,0,0,0,25,25,0,0,53,0,1,32.0,1,19,78,26,0.0,100.0,1.37,0,,,0,,0,0,26,0,0,1.37,26
Jai Bhagwan,U Mumba,0,0,1,4,2,7,75,0,26,5,5,0,49,10,31,67,33.0,163,19,15,82,3.95,71.78,0.37,0,,,0,,46,50,7,0,0,4.32,82
Md. Arif Rabbani,Tamil Thalaivas,0,0,0,0,1,3,0,0,0,2,2,0,0,3,0,1,40.0,2,2,5,3,0.0,50.0,1.5,0,,,0,,1,0,3,0,0,1.5,3
Md. Liton Ali,Dabang Delhi K.C.,0,0,0,0,0,0,0,0,0,0,0,0,0,0,0,0,0.0,0,0,0,0,0.0,0.0,0.0,0,,,0,,0,0,0,0,0,0.0,0
Thanushan Laxmamohan,Tamil Thalaivas,0,0,0,0,0,0,0,0,0,0,0,0,0,0,0,0,0.0,0,0,0,0,0.0,0.0,0.0,0,,,0,,0,0,0,0,0,0.0,0
Gholamabbas Korouki,U Mumba,0,0,0,0,0,0,0,0,0,0,0,0,0,0,0,0,0.0,0,0,0,0,0.0,0.0,0.0,0,,,0,,0,0,0,0,0,0.0,0
Heidarali Ekrami,U Mumba,0,0,0,2,1,2,32,0,9,1,1,0,23,2,33,22,33.0,64,12,3,34,2.67,67.19,0.17,0,,,0,,21,21,2,0,0,2.83,34
Mohammad Ghorbani,Gujarat Giants,0,0,0,0,0,1,0,0,0,1,1,0,0,0,0,1,100.0,1,1,1,1,0.0,100.0,1.0,0,,,0,,0,0,1,0,0,1.0,1
Reza Katoulinezhad,Dabang Delhi K.C.,0,0,0,0,0,0,0,0,0,0,0,0,0,0,0,0,0.0,0,0,0,0,0.0,0.0,0.0,0,,,0,,0,0,0,0,0,0.0,0
Reza Mirbagheri,Jaipur Pink Panthers,2,0,0,0,1,36,0,0,0,35,35,0,0,35,0,0,50.0,0,16,70,36,0.0,0.0,2.25,0,,,0,,0,0,36,0,0,2.25,36
Woosan Ko,Jaipur Pink Panthers,0,0,0,0,0,0,0,0,0,0,0,0,0,0,0,0,0.0,0,0,0,0,0.0,0.0,0.0,0,,,0,,0,0,0,0,0,0.0,0
Mohit,U Mumba,1,0,0,0,6,44,0,0,0,38,38,0,0,50,0,0,43.0,0,20,88,44,0.0,0.0,2.2,0,,,0,,0,0,44,0,0,2.2,44
Shivam Chaudhary,Patna Pirates,0,0,0,0,0,0,0,0,0,0,0,0,0,3,0,0,0.0,0,2,3,0,0.0,0.0,0.0,0,,,0,,0,0,0,0,0,0.0,0
Kiran Magar,U Mumba,0,0,0,0,3,21,0,0,0,18,18,0,0,27,0,0,40.0,0,16,45,21,0.0,0.0,1.31,0,,,0,,0,0,21,0,0,1.31,21
Shankar Gadai,Gujarat Giants,0,0,0,0,0,21,4,0,0,21,21,0,4,44,36,7,32.0,11,20,65,25,0.2,100.0,1.05,0,,,0,,0,4,21,0,0,1.25,25
Lucky Sharma,Jaipur Pink Panthers,1,0,0,0,3,11,0,0,0,8,8,0,0,10,0,0,44.0,1,15,18,11,0.0,0.0,0.73,0,,,0,,1,0,11,0,0,0.73,11
Visvanath V,Tamil Thalaivas,0,0,0,0,3,8,13,0,1,5,5,0,12,13,29,16,28.000000000000004,34,11,18,21,1.18,76.47,0.73,0,,,0,,8,10,8,0,0,1.91,21
Alankar Patil,Puneri Paltan,0,0,0,0,0,3,0,0,0,3,3,0,0,6,0,0,33.0,0,3,9,3,0.0,0.0,1.0,0,,,0,,0,0,3,0,0,1.0,3
Rakesh Ram,Puneri Paltan,0,0,0,0,0,1,1,0,1,1,1,0,0,13,0,2,7.000000000000001,3,8,14,2,0.12,66.67,0.12,0,,,0,,1,0,1,0,0,0.25,2
Navneet,Haryana Steelers,0,0,0,0,0,0,0,0,0,0,0,0,0,3,0,0,0.0,0,1,3,0,0.0,0.0,0.0,0,,,0,,0,0,0,0,0,0.0,0
Manish Gulia,Haryana Steelers,0,0,0,1,0,1,13,0,3,1,1,0,10,0,45,3,100.0,20,4,1,14,3.25,60.0,0.25,0,,,0,,8,9,1,0,0,3.5,14
Akshay Jaywant Bodake,Patna Pirates,0,0,0,0,0,0,0,0,0,0,0,0,0,0,0,0,0.0,0,0,0,0,0.0,0.0,0.0,0,,,0,,0,0,0,0,0,0.0,0
Rahul Dhanawade,Jaipur Pink Panthers,0,0,0,0,0,0,0,0,0,0,0,0,0,1,0,0,0.0,1,1,1,0,0.0,0.0,0.0,0,,,0,,1,0,0,0,0,0.0,0
Sumit,Telugu Titans,0,0,0,0,0,0,0,0,0,0,0,0,0,0,0,0,0.0,0,0,0,0,0.0,0.0,0.0,0,,,0,,0,0,0,0,0,0.0,0
Harsh Lad,Puneri Paltan,0,0,0,0,1,4,0,0,0,3,3,0,0,3,0,0,50.0,0,1,6,4,0.0,0.0,4.0,0,,,0,,0,0,4,0,0,4.0,4
Naveen Sharma,Patna Pirates,0,0,0,0,1,4,1,0,1,3,3,0,0,10,0,0,23.0,1,8,13,5,0.12,0.0,0.5,0,,,0,,1,0,4,0,0,0.62,5
Ranjit Naik,Patna Pirates,0,0,0,0,0,2,15,0,2,2,2,0,13,2,33,11,50.0,33,7,4,17,2.14,66.67,0.29,0,,,0,,11,11,2,0,0,2.43,17
Thiyagarajan Yuvaraj,Patna Pirates,0,0,0,0,0,5,0,0,0,5,5,0,0,8,0,0,38.0,0,3,13,5,0.0,0.0,1.67,0,,,0,,0,0,5,0,0,1.67,5
Narender,Tamil Thalaivas,0,0,15,4,0,6,243,0,70,6,6,0,173,10,48,116,38.0,405,23,16,249,10.57,76.79,0.26,0,,,0,,94,195,6,0,0,10.83,249
Vinay,Telugu Titans,0,0,0,1,1,4,38,0,16,3,3,0,22,10,27,42,23.0,95,15,13,42,2.53,71.58,0.27,0,,,0,,27,26,4,0,0,2.8,42
Vijay Kumar,Dabang Delhi K.C.,0,0,0,0,2,19,0,0,0,17,17,0,0,46,0,0,27.0,0,18,63,19,0.0,0.0,1.06,0,,,0,,0,0,19,0,0,1.06,19
Parshant Kumar,Bengal Warriors,0,0,0,0,0,0,2,0,1,0,0,0,1,0,18,5,0.0,11,1,0,2,2.0,63.64,0.0,0,,,0,,4,2,0,0,0,2.0,2
Rajnesh,Bengaluru Bulls,0,0,0,0,1,2,0,0,0,1,1,0,0,12,0,0,8.0,0,5,13,2,0.0,0.0,0.4,0,,,0,,0,0,2,0,0,0.4,2
Yash Hooda,Bengaluru Bulls,0,0,0,0,0,0,0,0,0,0,0,0,0,0,0,0,0.0,0,0,0,0,0.0,0.0,0.0,0,,,0,,0,0,0,0,0,0.0,0
Ashish Narwal,Dabang Delhi K.C.,0,0,0,0,0,0,10,0,3,0,0,0,7,0,30,6,0.0,20,7,0,10,1.43,60.0,0.0,0,,,0,,8,6,0,0,0,1.43,10
Monu Hooda,Haryana Steelers,1,0,0,0,1,17,0,0,0,16,16,0,0,18,0,0,47.0,0,14,34,17,0.0,0.0,1.21,0,,,0,,0,0,17,0,0,1.21,17
Naveen Kundu,Haryana Steelers,1,0,0,0,0,9,0,0,0,9,9,0,0,5,0,0,64.0,0,2,14,9,0.0,0.0,4.5,0,,,0,,0,0,9,0,0,4.5,9
Harsh,Haryana Steelers,0,0,0,0,0,5,0,0,0,5,5,0,0,6,0,0,45.0,1,5,11,5,0.0,0.0,1.0,0,,,0,,1,0,5,0,0,1.0,5
Sunny Sehrawat,Haryana Steelers,1,0,0,0,1,9,0,0,0,8,8,0,0,16,0,0,33.0,0,6,24,9,0.0,0.0,1.5,0,,,0,,0,0,9,0,0,1.5,9
Ashish,Jaipur Pink Panthers,0,0,0,0,0,1,0,0,0,1,1,0,0,5,0,0,17.0,0,4,6,1,0.0,0.0,0.25,0,,,0,,0,0,1,0,0,0.25,1
Devank,Jaipur Pink Panthers,0,0,0,0,0,0,4,0,3,0,0,0,1,0,18,3,0.0,11,5,0,4,0.8,45.45,0.0,0,,,0,,6,2,0,0,0,0.8,4
Anuj Kumar,Patna Pirates,0,0,0,0,0,0,12,0,7,0,0,0,5,2,19,15,0.0,37,5,2,12,2.4,59.46,0.0,0,,,0,,15,7,0,0,0,2.4,12
Badal Singh,Puneri Paltan,0,0,0,0,1,7,0,0,0,6,6,0,0,5,0,0,55.00000000000001,1,12,11,7,0.0,0.0,0.58,0,,,0,,1,0,7,0,0,0.58,7
Mohit Pahal,Telugu Titans,0,0,0,0,2,6,1,0,1,4,4,0,0,5,0,0,44.0,2,3,9,7,0.33,0.0,2.0,0,,,0,,2,0,6,0,0,2.33,7
Mohit,Telugu Titans,0,0,0,0,0,3,0,0,0,3,3,0,0,11,0,0,21.0,0,5,14,3,0.0,0.0,0.6,0,,,0,,0,0,3,0,0,0.6,3
Nitin,Telugu Titans,0,0,0,0,1,4,1,0,1,3,3,0,0,23,0,0,12.0,1,8,26,5,0.12,0.0,0.5,0,,,0,,1,0,4,0,0,0.62,5
Rupesh,U Mumba,0,0,0,0,0,0,0,0,0,0,0,0,0,0,0,1,0.0,2,1,0,0,0.0,50.0,0.0,0,,,0,,1,0,0,0,0,0.0,0
Abhishek KS,Jaipur Pink Panthers,1,0,0,0,2,25,0,0,0,23,23,0,0,52,0,0,31.0,0,18,75,25,0.0,0.0,1.39,0,,,0,,0,0,25,0,0,1.39,25
Vaibhav Garje,Bengal Warriors,1,0,0,0,1,30,1,0,1,29,29,0,0,54,0,0,35.0,1,18,83,31,0.06,0.0,1.67,0,,,0,,1,0,30,0,0,1.72,31
Suyog Gaikar,Bengal Warriors,0,0,0,0,0,0,3,0,0,0,0,0,3,3,27,3,0.0,11,2,3,3,1.5,54.55,0.0,0,,,0,,5,3,0,0,0,1.5,3
Aditya Shinde,Puneri Paltan,0,0,1,1,0,0,20,0,7,0,0,0,13,2,42,6,0.0,31,6,2,20,3.33,61.29,0.0,0,,,0,,12,13,0,0,0,3.33,20
Pranay Rane,U Mumba,0,0,1,0,0,1,25,0,5,1,1,0,20,3,43,8,25.0,47,11,4,26,2.27,59.57,0.09,0,,,0,,19,20,1,0,0,2.36,26
Mahipal,U.P. Yoddhas,0,0,0,1,0,0,11,0,5,0,0,0,6,2,31,8,0.0,26,5,2,11,2.2,61.54,0.0,0,,,0,,10,8,0,0,0,2.2,11
Sachin,U Mumba,0,0,0,0,0,0,0,0,0,0,0,0,0,0,0,0,0.0,1,1,0,0,0.0,0.0,0.0,0,,,0,,1,0,0,0,0,0.0,0
R Guhan,Bengal Warriors,0,0,0,0,0,0,6,0,1,0,0,0,5,0,43,2,0.0,14,3,0,6,2.0,57.14,0.0,0,,,0,,6,6,0,0,0,2.0,6
Anil Kumar,U.P. Yoddhas,0,0,0,1,0,1,17,0,3,1,1,0,14,1,31,15,50.0,39,7,2,18,2.43,69.23,0.14,0,,,0,,12,12,1,0,0,2.57,18
Rohan Singh,Gujarat Giants,0,0,0,0,0,0,0,0,0,0,0,0,0,0,0,0,0.0,1,1,0,0,0.0,0.0,0.0,0,,,0,,1,0,0,0,0,0.0,0
Suraj Panwar,Dabang Delhi K.C.,0,0,0,0,0,0,0,0,0,0,0,0,0,0,0,0,0.0,0,0,0,0,0.0,0.0,0.0,0,,,0,,0,0,0,0,0,0.0,0
Parteek Dahiya,Gujarat Giants,0,0,11,4,0,5,178,0,27,5,5,0,151,28,52,61,15.0,240,19,33,183,9.37,77.08,0.26,0,,,0,,55,124,5,0,0,9.63,183
Marimuthu Kamaraj,Jaipur Pink Panthers,0,0,0,0,0,0,0,0,0,0,0,0,0,0,0,0,0.0,0,0,0,0,0.0,0.0,0.0,0,,,0,,0,0,0,0,0,0.0,0
Gaurav Khatri,Puneri Paltan,0,0,0,0,2,20,1,0,0,18,18,0,1,20,17,4,47.0,6,16,38,21,0.06,83.33,1.25,0,,,0,,1,1,20,0,0,1.31,21
Sachin,Tamil Thalaivas,0,0,0,0,0,0,12,0,4,0,0,0,8,2,32,9,0.0,31,9,2,12,1.33,61.29,0.0,0,,,0,,12,10,0,0,0,1.33,12
Priyank Chandel,Gujarat Giants,0,0,0,0,0,1,0,0,0,1,1,0,0,3,0,0,25.0,0,3,4,1,0.0,0.0,0.33,0,,,0,,0,0,1,0,0,0.33,1
